101 WILSON BAR	Bar/Pub
1020 Bar	Bar/Pub
11TH ST BAR	Bar/Pub
11th St. Bar	Bar/Pub
11th Street Cafe	Cafe/Coffee
12 Chairs Cafe	Israeli
1590 LUPITA RESTAURANT CORP	Mexican
16 Handles	Ice Cream/Dessert
169 Bar	Bar/Pub
18th Ward Brewing	Bar/Pub
1900 JEROME AVE SPORTS BAR INC	Bar/Pub
200 Gram Noodles	Vietnamese
21 BAR CORP	Bar/Pub
212 E Hisae	Japanese
212 Steakhouse Inc	Steakhouse
2nd Avenue Stube LLC	German
2nd lhasa fast food inc	Fast Food
35-09 Ditmars Bagel Corp	Bagels
352 EL CLUB VALLE RESTAURANT CORP	Mexican
369BBQ	BBQ
4 caminos	Mexican
4 Charles Prime Rib	Steakhouse
4360 rincon latino	Caribbean
5 DE MAYO IN NY INC	Mexican
5 Napkin  Burger	American
5 Napkin Burger	American
547 LENOX BARBQ REST CORP	BBQ
652 LIN'S GARDEN	Chinese
68 Jay Street Bar	Bar/Pub
773 Lounge	Bar/Pub
787 COFFEE	Cafe/Coffee
787 COFFEE ROASTERS	Cafe/Coffee
789 cocina latina restaurant	Caribbean
7B Horseshoe Bar	Bar/Pub
7TH STREET BURGER	American
8-BIT BITES	American
861 La Rubia Restaurant	Dominican
88 18 TROPICAL RESTAURANTE CORP	Caribbean
88 Weijia	Chinese
886	Taiwanese
99 Noodle Village LLC	Chinese
A CHURRASQUEIRA RESTAURANT	Portuguese
A Gusto	Italian
A&L DELI & MEAT MARKET	Deli
A&T Fish and Chips LLc	British
A-Pou's Taste	Taiwanese
A-UN	Japanese
a.cafe	Cafe/Coffee
Aahar	Indian
aahar indina cuisine	Indian
Abbey Tavern	Bar/Pub
abcV, abc Cocina	Mexican
Abe's Pagoda Bar	Bar/Pub
ABOUT COFFEE	Cafe/Coffee
Abracadabra Magic Deli	Deli
Absolute Coffee	Cafe/Coffee
Abys bar	Bar/Pub
Ace Bar	Bar/Pub
Acento Latin Kitchen & Bar	Caribbean
Acey DuceyGCOs	Bar/Pub
Achilles Heel	Bar/Pub
Acitrezza, LLC	Italian
Action Burger	American
ADDA	Indian
ADDEO'S OF THE BRONX	Italian
Addictive Wine  Bar Corporation	Bar/Pub
Adoro Lei	Italian
ADRIAN TROPICAL	Dominican
AFFICIONADO COFFEE ROASTERS	Cafe/Coffee
AFRICA KINE RESTO LLC	Senegalese
Agata & Valentina	Italian
AGAVE	Mexican
Agavi Juice	Juice/Smoothie
Aged steakhouse	Steakhouse
AGNANTI RESTAURANT	Greek/Mediterranean
Agora Taverna	Greek/Mediterranean
Agra Palace Restaurant & Party Hall	Indian
ahuachapan restaurant	Salvadoran
AJIHEI	Japanese
AJO Y OREGANO RESTAURANT INC	Mexican
AKROTIRI	Greek/Mediterranean
AL AQSA RESTAURANT	Lebanese
al noor restaurant ing	Indian
Al-Sham Restaurant	Syrian
Ala Turk Inc	Turkish
ALBERT'S COFFEE SHOP	Cafe/Coffee
Alcala Restaurant	Spanish
ALIADA	Greek/Mediterranean
ALIBI CLUB	Bar/Pub
Alibi Lounge	Bar/Pub
alice's tea cup	Cafe/Coffee
Allerton diner Inc	Diner
ALLEVA DAIRY INC	Italian
Almaz Resturant	Ethiopian
Alphabet City Beer Co.	Bar/Pub
Amarachi Restaurant	Nigerian
Amaru Bar	Bar/Pub
Amber Steakhouse	Steakhouse
AMELIE	French
amelie wine bar	French
American Bar	Bar/Pub
AMERICAN BRASS	American
AMERICAN CUT	Steakhouse
American Retro Bar and Grill	American
AMERICAN STAR DELI	Deli
AMERICAN VEGAN	Vegan/Vegetarian
American Whiskey NYC	American
American Whiskey TriBeCa	American
Amici Del Caffe Inc.	Italian
Amity Hall	Bar/Pub
Amity Hall Uptown	Bar/Pub
AMMA	Indian
Ammos Estiatorio	Greek/Mediterranean
Amor y Amargo	Bar/Pub
Amores Juice Bar Inc	Juice/Smoothie
Amorina, Cucina Rustica	Italian
Ample Hills Creamery	Ice Cream/Dessert
AmyGCOs Bread	Bakery
Amylos Taverna	Greek/Mediterranean
AN'NAM	Vietnamese
ANA'S BAKERY &amp; CAFE	Bakery
Ananda	Indian
andrews classic bklyn luncheonette	Diner
ANDREWS COFFEE SHOP	Cafe/Coffee
Anejo Restaurant	Mexican
Anejo Tribeca	Mexican
Anfora	Bar/Pub
Angaar	Indian
Angel's Share / Village Yokocho	Japanese
Angelica's Coffee Shop LLC	Cafe/Coffee
Angelina Bakery	Bakery
Angiolina's Restaurant	Italian
ANGRLINA PARIS	French
Angry Wade's Inc.	Bar/Pub
Anmwey Eatery	Korean
Annapurna Thakali Kitchen Inc	Nepali
Annie MooreGCOs	Irish
ANNIE MOORES PUB &amp; RESTAURANT	Irish
Anotheroom	Bar/Pub
Antica Pesa	Italian
Antiochia Grill	Turkish
ANTIOQUENA BAKERY VII INC	Colombian
ANTIOQUENA II BAKERY	Colombian
ANTOJITOS	Mexican
ANTOJITOS ECUATORIANOS	Ecuadorian
ANTOJITOS ECUATORIANOS 3	Ecuadorian
Antonucci Cafe	Italian
ANYTIME BAR &amp; BILLIARDS	Bar/Pub
Anytime Soju INC	Korean
Anzuelo Fino	Peruvian
AOI Kitchen	Japanese
Aperitivo di Palma	Italian
Apotheke	Bar/Pub
APPETHAIZE	Thai
APPLEBEE'S	American
Aqua Boil	Seafood
ARAGVI	Georgian
Arberia	Italian
Arch Diner	Diner
ARCHIES	American
Ardesia Wine Bar	Bar/Pub
Areppas	Venezuelan
Areppas LLC	Venezuelan
ARIA KABAB	Afghan
ARIAPITA RESTAURANT	Trinidadian
ARIARI	Korean
Ariccia	Italian
Aroma Coffee Shop	Cafe/Coffee
Aroma de Cafe Bakery Restaurant INC	Bakery
Aroma Espresso Bar	Cafe/Coffee
ARRIBA ARRIBA	Mexican
Art Bar	Bar/Pub
Arte Cafe	Italian
ARTHUR'S TAVERN	Bar/Pub
Arts and Crafts Beer Parlor	Bar/Pub
ARTURO'S RESTAURANT	Italian
ArturoGCOs	Italian
Artuso Pastry Shop	Bakery
ASHOKA	Indian
Astoria Ale House	Bar/Pub
Astoria Bier & Cheese Broadway	Bar/Pub
Astoria Bier and Cheese-Ditmars	Bar/Pub
Astoria Sea Food & Grill Inc	Seafood
Astoria Tavern	Bar/Pub
ATLA	Mexican
ATM VEGAN DELI	Vegan/Vegetarian
Attraversa	Italian
Au Za'atar	Lebanese
Aunt Jake's	Italian
AURA COCINA & BAR INC	Mexican
Aura Coffee	Cafe/Coffee
AURA KITCHEN AND BAR	Mexican
Auriga Cafe	Cafe/Coffee
Aurora Brooklyn	Italian
AURORA SOHO	Italian
Austin Ale House	Bar/Pub
Avant Garden	Vegan/Vegetarian
AVENA	Italian
AVENA UES	Italian
AVOCADERIA	Vegan/Vegetarian
AVRILILILLYS CREAMERY	Ice Cream/Dessert
AWADH	Indian
Awang Kitchen	Malaysian
Ay que Rico	Caribbean
AYADA	Thai
AYAT	Turkish
Ayna Agra	Indian
Ayurveda Cafe	Indian
Ayza Wine & Chocolate Bar	Bar/Pub
Azogue+?ita Bakery & Restaurant	Bakery
Azoguenita criolla bakery restaurant	Bakery
B &amp; B BAGELS	Bagels
B&H Dairy Kosher Vegetarian Restaurant	Vegan/Vegetarian
B'ARTUSI AND VIA PORTA	Italian
B-CUP CAFE	Cafe/Coffee
B-side	Bar/Pub
B.Cafe	Cafe/Coffee
Baar Baar Restaurant	Indian
BABA COOL	Cafe/Coffee
BABAGHANOJ SPOT	Greek/Mediterranean
BABY BRASA	Peruvian
Bacaro	Italian
Baci & Abbracci	Italian
Back Pocket Bar	Bar/Pub
Baekjeong NYC	Korean
BAGEL BOB'S	Bagels
Bagel Boss	Bagels
BAGEL CAFE	Bagels
BAGEL EXPRESS	Bagels
BAGEL POINT	Bagels
BAGEL PUB	Bagels
Bagel Schmagel Corporation	Bagels
BAGEL STORY	Bagels
Bagel Villa	Bagels
Bagel works	Bagels
BAGELS & CO	Bagels
Bagels and Cream	Bagels
Bagels plus	Bagels
BAGOCK Fried Chicken & Doughnuts	American
BAHARI ESTIATORIO	Greek/Mediterranean
Bailey Seafood Market and Resturant Corp	Seafood
Bajeko Sekuwa	Nepali
BAKERI	Bakery
BAKERIE NY LLC	Bakery
BAKERS CAFE	Bakery
BAKERY RESTAURANT LOS PARCEROS	Colombian
Bakestone Bakery	Bakery
Balaboosta	Israeli
Balade	Lebanese
BALLATOS RESTAURANT CORP	Italian
Balthazar Bakery	Bakery
BALTHAZAR RESTAURANT	French
BALZEM	Bakery
BAMBOO WALK	Caribbean
Bamboo Ya	Japanese
BAMONTE'S RESTAURANT	Italian
Banc Cafe	Cafe/Coffee
BANGIA	Bangladeshi
Bangklyn East Harlem	Thai
BANH	Vietnamese
Baoburg	Taiwanese
Bapsang	Korean
Bar 43	Bar/Pub
Bar 718	Bar/Pub
Bar 9	Bar/Pub
Bar B	Bar/Pub
BAR BASIC	Bar/Pub
Bar Belly	Bar/Pub
Bar Boulud	French
Bar Bruno	Italian
Bar Camillo	Italian
BAR CHUKO	Japanese
Bar Coastal NYC	Bar/Pub
Bar Crudo	Bar/Pub
Bar Culaccino	Italian
Bar Dalia	Bar/Pub
Bar Goto	Japanese
Bar Great Harry	Bar/Pub
Bar Meridian	Bar/Pub
BAR MOGA	Japanese
Bar None	Bar/Pub
BAR PITTI	Italian
BAR PRIMI	Italian
Bar Restaurant La Ruana Paisa	Colombian
BAR SIX	Bar/Pub
bar tabac	French
Bar Toto	Italian
BAR VELOCE	Italian
Bar Verde	Bar/Pub
BARACHOU	French
Barano Restaurant	Italian
Barbalu	Italian
Barbaresco	Italian
Barbes	Bar/Pub
Barboncino	Pizza
Barbounia	Greek/Mediterranean
barbuto	Italian
Barcade	Bar/Pub
BarDough	Italian
Bareburger	American
Bareburger Astoria	American
Bareburger Ditmars	American
Bareburger LIC	American
BARELY DISFIGURED	Bar/Pub
BARKING DOG	American
BARLEY DISFIGURED	Bar/Pub
Barn Joo USQ	Korean
Barnacho	Bar/Pub
BARNES &amp; NOBLE CAFE	Cafe/Coffee
Barney Greengrass	Deli
BARNJOO	Korean
BARO by Chefs Society	Korean
Barolo east	Italian
BARRAGE	Bar/Pub
Barranquilla Bakery	Colombian
Barrio Chino	Mexican
Barrows Pub	Bar/Pub
Bases Loaded Sports Bar Inc	Bar/Pub
BASQUIAT'S BOTTLE	Bar/Pub
BATHHOUSE	Bar/Pub
Bathtub Gin	Bar/Pub
Battle Hill Tavern	Bar/Pub
BAY BAGELS	Bagels
Bay Parkway Seafood Palace Inc	Seafood
Bay Ridge Diner	Diner
Bayards Ale House	Bar/Pub
Bayou Restaurant	American
Bayside Diner	Diner
BBQ OLIVE CHICKEN	Korean
BCakeNY	Bakery
BCD TOFU HOUSE	Korean
BEAN &amp; BARLEY	Bar/Pub
Bean Post Pub	Bar/Pub
Bean&Bean	Cafe/Coffee
Beans and leaves coffee and tea cafe	Cafe/Coffee
Beatstro	American
Beauty Bar	Bar/Pub
Becco Restaurant	Italian
BECKETTS BAR & GRILL	Bar/Pub
Beco	Brazilian
Bee Cafe Inc	Cafe/Coffee
BEEPUBLIC	Bar/Pub
Beer Culture	Bar/Pub
BEER KARMA	Bar/Pub
BEER RUN	Bar/Pub
BEER WITCH	Bar/Pub
Beets and Carrots	Vegan/Vegetarian
Beets Cafe	Vegan/Vegetarian
Behans Pub	Irish
bekys bakery & coffee shop	Bakery
Bel Aire Diner	Diner
Bel-Fries	Belgian
BELLA BLU	Italian
BELLA LUNA	Italian
Bella Notte	Italian
Bella Via Restaurant	Italian
BellaGCOs place restaurant	Italian
Belle Harlem	American
Bellini	Italian
Bello Deli Food Corp	Deli
Bellwether	American
BELLY CAKES	Bakery
BELO GRILL	Brazilian
BEN & JACK'S STEAKHOUSE	Steakhouse
Ben & Teena's Ice Cream	Ice Cream/Dessert
Benares	Indian
Benares restaurant	Indian
BENJAMIN STEAK HOUSE	Steakhouse
Benjamin Steakhouse Prime	Steakhouse
Berber Street Food	Moroccan
bergen bagel	Bagels
Bergen Bagels	Bagels
Beriozka Rest Corp	Russian
BEST BAGEL &amp; COFFEE	Bagels
Bettola	Italian
Bettolona	Italian
BHANCHHA GHAR II, INC.	Nepali
BICKLES TO GO	Jamaican
BIEN CUIT	Bakery
Bierhaus NYC	German
BierWax	Bar/Pub
BIERWAXQUEENS	Bar/Pub
Big aLICe Brewing Company	Bar/Pub
Big Bar	Bar/Pub
big nick's	American
Bill's Bar & Burger	American
BILLY'S BAKERY	Bakery
billys sports bar	Bar/Pub
Bilt Bar	Bar/Pub
BIN 141	Bar/Pub
Bin 71	Bar/Pub
Bin no. 220	Bar/Pub
BIRCH COFFEE	Cafe/Coffee
Biricchino	Italian
Biskoti Bakery Cafe	Bakery
Bistango at the Kimberly Hotel	Italian
BK LOBSTER	Seafood
BKK EATERY	Thai
BKLYN CAKE STUDIO	Bakery
BKLYN CREPE	French
Bklyn Prime	Steakhouse
Black Barn Restaurant	American
Black Brick	Cafe/Coffee
Black Emperor Bar	Bar/Pub
Black Forest Brooklyn - Fort Greene	German
Black Horse Pub	Bar/Pub
BLACK IRON BURGER	American
BLACK LAB COFFEE INC.	Cafe/Coffee
Black Press Coffee	Cafe/Coffee
Black Rabbit	Bar/Pub
Black Seed Bagels	Bagels
BLACK STAR BAKERY &amp; CAFE	Bakery
Black Star Bakery &amp; Kitchen	Bakery
Black Star Bakery&Cafe	Bakery
Black Swan	Bar/Pub
BLACK TAP	American
BLACK TAP CRAFT BURGERS AND BEER, LOT 15	American
Blackbird's Bar and Restaurant	Bar/Pub
Blackstone bar and grill	Bar/Pub
Blackstone Coffee Roasters	Cafe/Coffee
BlackwellGCOs pub and restaurant	Bar/Pub
BLAGGARD'S PUB	Bar/Pub
Blanches Tavern	Bar/Pub
Blank Slate Coffee + Kitchen (Midtown)	Cafe/Coffee
Blank Slate Coffee + Kitchen (NoMad)	Cafe/Coffee
Blank Slate Coffee + Kitchen NoMad	Cafe/Coffee
Blank Slate Tea	Cafe/Coffee
Blank Street	Cafe/Coffee
BLANK STREET - SPRINGBONE	Cafe/Coffee
BLANK STREET COFFEE	Cafe/Coffee
Blarney Stone Bar and Restaurant	Irish
BLEACHERS SPORTS BAR	Bar/Pub
Bleecker Street Bar	Bar/Pub
Blend Coffee + CoWork	Cafe/Coffee
Blendzville Cafe Inc	Cafe/Coffee
Bleu Fin Bar & Grill	Seafood
Bleu Royale Cakes	Bakery
Blind Tiger	Bar/Pub
Blockheads	Mexican
Blondies	Bar/Pub
Blooms Tavern	Bar/Pub
Blossom	Vegan/Vegetarian
Blossom on Columbus	Vegan/Vegetarian
BLT Prime	Steakhouse
BLT Steak	Steakhouse
Blue Agave Restaurant and Tequileria	Mexican
Blue Bakery	Bakery
Blue Bottle	Cafe/Coffee
BLUE BOTTLE COFFEE	Cafe/Coffee
Blue Corn Restaurant Corp	Mexican
Blue Fin/Dos Caminos	Seafood
BLUE MAIZ	Mexican
BLUE MARBLE ICE CREAM	Ice Cream/Dessert
Blue Marble Ice Creamn	Ice Cream/Dessert
BLUE RIBBON	American
Blue Sky Bakery	Bakery
Blue Tequila Restaurant	Mexican
Blue Tequila Restaurant and Bar Inc.	Mexican
BLUE TIJUANA	Mexican
Blueprint Bar	Bar/Pub
Bluestone Lane	Cafe/Coffee
BLVD 93 NYC	Bar/Pub
BLVD DINER	Diner
Blvd prime grill	Steakhouse
BLVD Wine Bar	Bar/Pub
BOAT BAR	Bar/Pub
Bobba Hubba	Cafe/Coffee
Bobbi's Beef	Steakhouse
Bobby Van's	Steakhouse
Bobby Vans steakhouse	Steakhouse
Bobwhite Counter	American
BOBWHITE COUNTER.	American
Boca Juniors steakhouse	Steakhouse
BOCA RESTAURANT & STEAK HOUSE CORP	Steakhouse
Boca Restaurant & Steak house Corp.	Steakhouse
BOCA RESTAURANT &amp; STEAK HOUSE	Steakhouse
Bocado Cafe	Cafe/Coffee
Bocaito	Spanish
BOCAPHE	Vietnamese
Bocca Cucina and Bar	Italian
Bocca di Bacco	Italian
bodhi kosher vegan restaurant	Vegan/Vegetarian
Bodhi Kosher Vegetarian	Vegan/Vegetarian
Bodrum	Turkish
BOILERMAKER	Bar/Pub
Boilery Seafood and Grill	Seafood
BOISHAKHI RESTAURANT	Bangladeshi
BOKKI SEOUL FOOD	Korean
BOLERO	Dominican
BONAO BAR AND GRILL	Dominican
BONCHON	Korean
BOND ST	Japanese
BONDST	Japanese
Bondurants	Bar/Pub
Bonjour Crepes & Wine	French
BONNIE VEE	Bar/Pub
Bonnie's	Chinese
Bonnie's Grill	American
Boogie Down Grind Cafe	Cafe/Coffee
Bootleg bar	Bar/Pub
Boqueria	Spanish
Boran	Thai
Bordeaux	French
BORINQUENYA DELI RESTAURANT	Puerto Rican
Borjas Deli	Deli
Bosie	French
BOSINO	Italian
Botte Bar	Bar/Pub
Bottega	Italian
bottino	Italian
Boucherie Union Square	French
Boucherie West Village	French
BOUNDLESS PLAINS ESPRESSO	Cafe/Coffee
Bourbon Street	American
Boutros	Lebanese
BOWERY ELECTRIC	Bar/Pub
BOWERY MEAT COMPANY	Steakhouse
BOWERY ROAD	American
Brad's Burers	American
Brad's Burgers and BBQ	BBQ
Brady's Bar and Grill	Bar/Pub
BRAIN FOOD THE SMART KITCHEN	Vegan/Vegetarian
Branded Saloon	Bar/Pub
Brandy Library	Bar/Pub
Brass Monkey	Bar/Pub
Bravi Ragazzi	Italian
Brazen Fox Kitchen & Craft Beer	Bar/Pub
BRAZEN FOX KITCHEN AND BAR	Bar/Pub
Brazmex Cafe	Brazilian
BREADS BAKERY	Bakery
Briciola	Italian
Bricks & Hops Beer Garden	Bar/Pub
Bricolage	French
BRIDGES BAR	Bar/Pub
BRIGADEIRO BAKERY	Brazilian
Brisas de caribe	Caribbean
brisas del mar restaurant ny corp	Seafood
Brisas Del Mar seafood market II	Seafood
Broadstone Tap House	Bar/Pub
Broadway Bagels Inc	Bagels
BRONSON'S BURGERS	American
Bronx Alehouse	Bar/Pub
Bronx Brewery	Bar/Pub
BRONX BURGER HOUSE	American
Bronx Drafthouse	Bar/Pub
Bronx Ice Co	Ice Cream/Dessert
Brooklyn  Brew cafe	Cafe/Coffee
Brooklyn Bagel & Coffee Company	Bagels
Brooklyn bagels & more corp	Bagels
BROOKLYN BAGELS N MORE	Bagels
Brooklyn Bay Seafood	Seafood
brooklyn beans roastarey	Cafe/Coffee
Brooklyn Blend	Cafe/Coffee
Brooklyn Burgers & Beer	American
Brooklyn Burgers and Beer	American
Brooklyn chop house	Steakhouse
Brooklyn DOP	Italian
BROOKLYN FARMACY AND SODA FOUNTAIN	Ice Cream/Dessert
Brooklyn Habit	Cafe/Coffee
Brooklyn Heights Wine Bar	Bar/Pub
BROOKLYN HERO SHOP	Deli
BROOKLYN KOLACHE	Czech
Brooklyn Label	Bar/Pub
Brooklyn Pub	Bar/Pub
BROOKLYN PUBLIC HOUSE	Bar/Pub
Brooklyn Roasting Company	Cafe/Coffee
BROOKLYN SAFE HOUSE	Bar/Pub
Brooklyn Whiskers Bakery	Bakery
Brooklyn Winery	Bar/Pub
BROOME STREET BAKERY	Bakery
BROTHER JIMMY'S BBQ	BBQ
Brothers Bakery Cafe	Bakery
BUBBY'S	American
BUBBYS	American
Bucaros rest	Colombian
BUD &amp; BEAN	Cafe/Coffee
Buddakan	Chinese
Buddha Bodai	Chinese
Buffalo Wild Wings	American
Buka	Nigerian
Bukowski's	Bar/Pub
Bul inc	Korean
Bull Mc Cabes	Irish
Bunch-O-Bagels	Bagels
Bund on Broadway	Chinese
Bunna Cafe	Ethiopian
BUON GUSTO	Italian
Buona notte	Italian
BURGER &amp; LOBSTER	American
Burger Chimi Tropical	Dominican
BURGER CLUB	American
Burger Heights	American
Burger King	Fast Food
Burger Spot	American
BURGER TIME	American
Burger Village	American
Burgerim	American
Burgerology Astoria	American
Burp Castle	Belgian
BUS STOP DINER	Diner
Bushniwa	Japanese
Bushwick Bakery	Bakery
BUSHWICK GRIND COFFEE HOUSE	Cafe/Coffee
Bushwick Public House	Bar/Pub
Bustan NYC	Israeli
Butch and Coco Cafe	Cafe/Coffee
Butcher Bar	BBQ
Butcher's Son Burger	American
BUTTER LANE	Bakery
BUTTER RESTAURANT	American
Buttermilk Bar	Bar/Pub
buttermilk channel	American
BUUNNI COFFEE	Cafe/Coffee
Buvette	French
BXL CAFE	Belgian
BXL Zoute	Belgian
by CHLOE	Vegan/Vegetarian
BZ GRILL	Greek/Mediterranean
c. di palo	Italian
Cabana	Caribbean
Cachapa Cachapa 2 Corp	Venezuelan
CachapaGCOs Brooklyn	Venezuelan
Cachapas Y Mas	Venezuelan
CACHAPAS Y MAS EXPRESS	Venezuelan
CACIO E PEPE	Italian
CACIO VINO	Italian
CAFE ALTRO PARADISO	Italian
Cafe Argentino	Argentine
Cafe Argentino Inc	Argentine
cafe bench	Cafe/Coffee
CAFE BILBOQUET	French
Cafe Buon Gusto	Italian
CAFE BUUNNI	Cafe/Coffee
Cafe Cluny	French
CAFE COLETTE	Cafe/Coffee
Cafe Colonial Restaurant	Brazilian
Cafe Cortadito	Cuban
CAFE D'ALSACE	French
Cafe d'Avignon	French
CAFE DES AFFICHEF	French
Cafe du Soleil	French
Cafe Dushanbe	Uzbek
Cafe Fiorello	Italian
CAFE FRIDA	Mexican
CAFE GITANE	French
Cafe Grumpy	Cafe/Coffee
CAFE HENRI	French
CAFE JOAH	Korean
CAFE KATJA	Austrian
Cafe Kitsune	Japanese
CAFE KOLMARO	Korean
Cafe La Notte	Italian
Cafe La Notte II	Italian
Cafe Lalo	Cafe/Coffee
Cafe Leon Dore	Cafe/Coffee
Cafe Mistral	French
Cafe Mogador	Moroccan
Cafe Muscat	Cafe/Coffee
Cafe Ole	Cafe/Coffee
Cafe Rakka	Lebanese
Cafe Regular du Nord	French
Cafe Riazor	Spanish
Cafe Rue DIX	French
CAFE SAHARA INC	Cafe/Coffee
Cafe Social 68	Cafe/Coffee
CAFE SPAGHETTI	Italian
CAFE UN DEUX TROIS	French
CAFE VOLKAN	Turkish
Cafe y Algo Mas	Cafe/Coffee
cafe-flor	Cafe/Coffee
Caffe Aronne	Italian
Caffe Bene	Korean
Caffe Borbone	Italian
Caffe Buon Gusto	Italian
caffe e vino	Italian
CAFFE EGIDIO	Italian
Caffe Palermo	Italian
Caffe Panna	Italian
caffe Reggio	Italian
Caffe Roma	Italian
Caffe Torino	Italian
CAFFE VALENCIA	Italian
Caffe Vita Coffee Roasting Co.	Cafe/Coffee
CAFFEBENE	Korean
Cake Lords Bakery	Bakery
CALABRIJE'S MARGARITAS AND TACOS	Mexican
Calaca of Bk	Mexican
Calaveras Corner	Mexican
CALEXICO	Mexican
CALEXICO CARNE ASADA	Mexican
Caliente Cab Co	Mexican
CALLE 174 PESCADERIA	Dominican
CALLE DAO	Thai
Calle Dao Chelsea	Thai
CALLE OCHO	Cuban
Camillo	Italian
CAMINITO SPORT BAR & BILLIARDS	Bar/Pub
Campagna Quattro Gatti	Italian
Campagnola	Italian
Canal Bar	Bar/Pub
CANARA BAKERY	Bakery
Cancun cafe	Mexican
Candle Cafe	Vegan/Vegetarian
Cannelle LIC	French
CAPITOL DINER	Diner
Capizzi	Pizza
Cappuccino Cafe	Cafe/Coffee
Capri restaurant	Italian
CAPRIOTTI'S SANDWICH SHOP	Deli
CAPTAIN DAN'S GOOD TIME TAVERN	Bar/Pub
Capucine Coffee Shop	Cafe/Coffee
CAPUT MUNDI	Italian
Cara Mia	Italian
Caravaggio Restaurant	Italian
Caravan Uyghur Cuisine	Chinese
Carbone	Italian
Cardoncello diVino	Italian
CARIDAD EXPRESS	Dominican
CARIDAD EXPRESS RESTAURANT	Dominican
Caridad Restaurant	Dominican
CARIDAD SEA FOOD RESTAURANT CORP.	Dominican
Carmelo's	Italian
Carmine's	Italian
Carmines	Italian
CARROT TOP PASTRIES	Bakery
Casa Adela Restaurant	Puerto Rican
Casa Bella	Italian
Casa Bocado	Spanish
Casa Del Toro	Mexican
CASA ENRIQUE	Mexican
Casa La Femme	Egyptian
CASA LIMONE	Italian
CASA MEZCAL	Mexican
Casa Mono	Spanish
CASA MONO, BAR JAMON (NEXT DOOR)	Spanish
CASA NONNA	Italian
Casa Publica	Mexican
Casa Verde	Mexican
Casa Vieja Restaurant	Colombian
Casabe Bar & Grill	Dominican
CASSIDY'S ALE HOUSE	Bar/Pub
CASSIDY'S PUB	Bar/Pub
Castillo de Yaque Restaurant	Dominican
Castillo Restaurant	Dominican
CATCH STEAKHOUSE	Steakhouse
CATSKILL BAGEL CO.	Bagels
Ceci Restaurant Inc.	Italian
CELLINI	Italian
Cemitas El Tigre	Mexican
CENA	Italian
Cerveceria Havemeyer	Mexican
Cha Cha Matcha	Cafe/Coffee
cha chan tang	Chinese
CHAIKHANA 7:40	Uzbek
CHAIWALI	Indian
Chalait	Cafe/Coffee
CHAMA MAMA	Georgian
Champignon	French
Champignon Cafe Inc	French
CHAMPS DINER	Diner
CHANGLE CUISINE	Chinese
Chapati House NY	Indian
CHARLIE BIRD	Italian
CHARM BAR	Bar/Pub
Charm Kao	Thai
Chavela's	Mexican
CHEBI COFFEE SHOP	Cafe/Coffee
Cheburechnaya	Russian
Cheeky Sandwiches	Deli
CHEESEBOAT	Georgian
Cheesecake Diva	Ice Cream/Dessert
Chef Guo	Chinese
Chela	Mexican
Chela & Garnacha	Mexican
Chez Josephine	French
Chez Moi	French
Chez Nick	French
Chez Oskar	French
Chick Fil A	Fast Food
CHICK-FIL-A	Fast Food
Chick-fil-A 46th &amp; 6th In-Line	Fast Food
CHICK-FIL-A AT FULTON STREET	Fast Food
ChikaLicious Dessert Bar	Ice Cream/Dessert
Chikurin	Japanese
Chilo's	Mexican
CHIN GU NAE	Korean
Chinelos II	Mexican
Chingoo restaurant	Korean
Chingoo restsurant	Korean
Chingri Restaurant	Bangladeshi
Chinito Latino	Peruvian
CHIRPING CHICKEN	American
Chito Gvrito	Georgian
Cho Dang Gol	Korean
CHOCOBAR CORTES	Puerto Rican
CHOCOLATE EXPRESSO BAR	Cafe/Coffee
Cholula Deli	Deli
CHOLULA DELI GROCERY	Deli
CHONGKHO RESTAURANT	Thai
chongqing chicken pot	Chinese
CHOTE NAWAB	Indian
Christos steak House	Steakhouse
CHUAN TIAN XIA	Chinese
Chuko	Japanese
CHUN YANG	Chinese
Churrascaria Plataforma	Brazilian
Ciao bella	Italian
CIAO, GLORIA	Italian
Cibo e Vino	Italian
Ciccio	Italian
ciccios	Italian
Cinco De Mayo	Mexican
CINCO DE MAYO RESTAURANT	Mexican
CIPRIANI DOWNTOWN RESTAURANT	Italian
CITY BEER	Bar/Pub
City diner	Diner
CLEMENTINE BAKERY	Bakery
CLOISTERS DELI	Deli
Cobblestones Pub	Bar/Pub
Cocina Del Sur	Mexican
COCO PAZZERIA	Italian
COCO PAZZERIA SOUTH	Italian
COCO'S COFFEE HOUSE	Cafe/Coffee
COFFEE AVENUE	Cafe/Coffee
COFFEE CLOUD	Cafe/Coffee
Coffee Project NY	Cafe/Coffee
COFFEE RX	Cafe/Coffee
COFFEE UPLIFTS PEOPLE	Cafe/Coffee
COLBEH	Persian
COLLIDE BBQ FUSION	BBQ
COLUMBUS CEAFOOD	Seafood
COLUOMBA BAKERY	Bakery
COM TAM NINH KIEU	Vietnamese
compadres 77	Mexican
COMPILATION COFFEE	Cafe/Coffee
CON SABOR LATINO RESTAURANT INC	Dominican
CONEJA JUICE BAR LLC	Juice/Smoothie
COPA CABANA SEAFOOD AND BRUNCH	Seafood
COPPA	Italian
Copper & Oak	Bar/Pub
COPPER MUG COFFEE	Cafe/Coffee
Coppola's East	Italian
CORK WINE BAR	Bar/Pub
CorkyGCOs Diner	Diner
Corner House BBQ	BBQ
Cornerstone Tavern	Bar/Pub
Corona heights Subway Inc	Fast Food
Corrado Bakery	Bakery
CORRADO BREAD AND PASTRY	Bakery
Corthaiyou	Thai
Cositas ricas	Colombian
COSMIC DINER	Diner
Cotenna	Italian
Country House Diner	Diner
Cozy Soup & Burger	American
CRAB DU JOUR XPRESS	Seafood
CRAB HOUSE	Seafood
CRABS IN A BARREL	Seafood
CRABSTICKS	Seafood
Craft Empanadas  by S&R	Colombian
CRANBERRY CAFE	Cafe/Coffee
Crave Fishbar	Seafood
CREAM COFFEE SHOP	Cafe/Coffee
Crepe Factory	French
CREPES &. MORE INC	French
Crepes on Columbus	French
CRIF DOGS	American
CROMPTON ALE HOUSE	Bar/Pub
CRONIN AND PHELAN	Irish
Crosstown diner	Diner
Croton Reservoir Tavern	Bar/Pub
CROWN FRIED CHICKEN	Fast Food
CROWN HEIGHTS CAFE	Cafe/Coffee
Croxley's Ale House	Bar/Pub
CRUSH BAR & LOUNGE	Bar/Pub
CUBBYHOLE	Bar/Pub
Cutterz Fish & Chipz	British
Cyclo	Vietnamese
D HACK'S HALAL	Indian
D HACKS HALAL INC	Indian
D'Amico Coffee Inc.	Cafe/Coffee
DA Andrea	Italian
Da Capo	Italian
Da Claudio	Italian
Da francesco	Italian
da gennaro	Italian
da Gennaro restaurant	Italian
Da Nico Restaurant	Italian
DA RADDA	Italian
Da Raffaele	Italian
DA TOSCANO	Italian
Da Umberto	Italian
DADA'S COFEE SHOP CORP	Cafe/Coffee
DADDYO'S BBQ	BBQ
DaddyOGCOs bbq	BBQ
Dae Bach Sik Dang	Korean
Dai Hachi Suchi Corp.	Japanese
Daikanyama	Japanese
daily bagel	Bagels
Dale Diner	Diner
Dallas BBQ	BBQ
Dan and John's Wings	American
Danji	Korean
DANNY'S ATHENS RESTAURANT	Greek/Mediterranean
DANNY'S TASTY DELIGHT BAKERY/RESTAURANT	Bakery
Darbar	Indian
Darbar Grill	Indian
Darbar's Group LTD	Indian
Darna restaurant	Moroccan
DAVE'S TAVERN	Bar/Pub
Davey's Ice Cream	Ice Cream/Dessert
DE MOLE ASTORIA	Mexican
DEAD RABBIT TAVERN	Irish
Dear Mama Coffee	Cafe/Coffee
Dek Sen	Thai
DELI EL BIGOTES	Deli
Delicias Cuencanas	Ecuadorian
DELICIAS RESTAURANT &amp; SEAFOOD	Seafood
DELICIAS TROPICAL	Dominican
DELIGHT WONG RESTAURANT	Chinese
Delillo pastry shop	Bakery
Delissimo Deli	Deli
Delizia Restaurant Corp.	Italian
Dell'Aria	Italian
Dellarocco's	Italian
Deluxe Green Bo	Chinese
DENG JI RESTAURANT	Chinese
DENGJI IIII RESTAURANT	Chinese
Deniz Restaurant	Turkish
Denny's	Diner
Dera Restaurant	Pakistani
Desi Galli	Indian
Desi Grill	Indian
DeStefanos Steakhouse	Steakhouse
DEUX AMIS	French
Devocion	Cafe/Coffee
DHAMAKA	Indian
Diamante Poblano Restaurant  Corp	Mexican
Die Stammkneipe - DSK Brooklyn	German
DIFARA	Pizza
DILLINGERS PUB &amp; GRILL	Bar/Pub
Diner	Diner
DINO	Italian
DINOSAUR BAR-B-QUE	BBQ
Dios Proveedor Bakery	Bakery
Dirt Candy	Vegan/Vegetarian
Dive Bar	Bar/Pub
Dive Bar LIC	Bar/Pub
Divya's Kitchen	Indian
DOC WINE BAR	Italian
Dok+?bi Bar and Grill	Korean
Dokdoya	Korean
Dolce Brooklyn	Italian
DOMINIQUE ANSEL BAKERY	Bakery
Domodomo Kitchen	Japanese
Don Angie	Italian
Don Antonio	Italian
Don Chucho	Mexican
Don Chucho Restaurant	Mexican
Don Filippo Restaurant	Italian
Don Giovanni	Italian
Don Miguel Restaurante	Mexican
DON POLLO	Peruvian
Donna Margherita	Italian
Donnybrook	Irish
Donohue's Cafe Inc.	Cafe/Coffee
DORADO TACOS	Mexican
Dos Caminos	Mexican
Dos Caminos & Troy Liquor Bar	Mexican
DOS MARES	Seafood
Dos Mares Seafood & Lounge Corp	Seafood
Double Zero	Vegan/Vegetarian
Dough	Bakery
Dough girl cupcakes	Bakery
Doughnut Plant	Bakery
Douzo	Japanese
Dove diner	Diner
Down the Hatch	Bar/Pub
Down the Road Pub	Bar/Pub
Downtown coffee	Cafe/Coffee
Downtown Yogurt & Ice Cream	Ice Cream/Dessert
Doyle's Corner	Irish
Dreamers Coffee	Cafe/Coffee
Drunken horse	French
Dua Kafe	Indonesian
dumont burger	American
DunHuang MissNoodle	Chinese
dunkin donuts	Fast Food
DunkinGCO Donuts	Fast Food
Duzan	Lebanese
Dyckman Dogs	American
DYNASTY RESTAURANT	Chinese
Earl's Beer & Cheese	American
EARLY BIRD COFFE	Cafe/Coffee
EAST COAST BURGERS	American
East One Coffee Roasters	Cafe/Coffee
EAST WIND SNACK SHOP	Chinese
Eataly	Italian
Ecuapollos Bar restaurant	Ecuadorian
Ecuatoriana Restaurant	Ecuadorian
ED'S LOBSTER BAR	Seafood
Ed's Lobster Bar LLC	Seafood
EFFY'S KITCHEN	Israeli
EL ABUELO GOZON	Mexican
El Anzuelo Fino	Mexican
EL ANZUELO FINO RESTAURANT	Mexican
El Atico Restaurant	Mexican
El Barril Restaurant & Lounge Corp	Dominican
el barrista cafe	Cafe/Coffee
El Bohio Sabroso	Dominican
El Born	Spanish
El buen gusto	Mexican
EL BUEN SABOR	Mexican
El Buen Sabor Deli Corp	Mexican
El Bukanitas	Mexican
EL CABRON TACOS AND MARISCOS	Mexican
El cafetal bakery	Bakery
EL CALDERO RESTAURANT SPORT BAR	Dominican
El Cantinero	Mexican
El Capri Restaurant	Mexican
El Castillo De Jagua Restaurant	Dominican
El Castillo de Manhattan Rest	Dominican
El Centro	Mexican
El Cerrito del Carmen Restaurant Inc.	Guatemalan
El changarito	Mexican
EL CHEVERE CUCHIFRITOS	Puerto Rican
El conde Nuevo	Dominican
El Continental Restaurant	Dominican
EL COYOTE	Mexican
El coyote bar & grill	Mexican
El Coyote Restaurant	Mexican
El Diamante Restaurant Corp	Dominican
EL DORADO RESTAURANT	Dominican
El Encanto de Lola 2	Mexican
EL ENCEBOLLADO DE VICTOR	Ecuadorian
EL ENCEBOLLADO DE VICTOR CORP	Ecuadorian
El encuentro restaurant	Dominican
El Familiar Restaurant	Dominican
EL FOCO ROJO	Mexican
EL FOGON REST INC	Mexican
EL FOGON RESTAURANT	Mexican
El gallo negro	Mexican
El gallo negro 2	Mexican
El Gaucito 1	Argentine
EL GRAN CANARIO II RESTAURANT	Dominican
El Gran Coffee Shop	Cafe/Coffee
EL GRAN MAR DE PLATA	Argentine
EL GRAN TEJANO	Mexican
El Jaguar Restaurant Corp	Mexican
EL JOBITO RESTAURANT	Dominican
EL JOBITO SEAFOOD RESTAURANT CORP	Dominican
El Kallejon	Mexican
EL KALLEJON BOTANAS	Mexican
El Lempiras Restaurant	Honduran
El lider bar restaurant	Dominican
EL MAGUEY	Mexican
el mambi steakhouse	Steakhouse
El Mariachi Restaurant	Mexican
El maya tavern	Mexican
El Mero Mero Restaurant	Mexican
EL MITOTE	Mexican
El Molcajete Restaurant Corp	Mexican
El Monta+?ero bakery & restaurant	Colombian
EL NOPAL RESTAURANT &amp; JUICE BAR	Mexican
El Nuevo Amanecer Restaurant	Dominican
El Nuevo Amanecer Restaurant and Lounge	Dominican
El nuevo Barzola 2 INC	Ecuadorian
El Nuevo Bonao Restaurant Corp	Dominican
EL NUEVO CAFE ESPANA	Dominican
El Nuevo Cafe Latino Corp.	Dominican
El Nuevo Caribe Restaurant	Dominican
EL NUEVO CEVICOS RESTAURANT CORP	Dominican
EL NUEVO IZALCO	Salvadoran
EL NUEVO JOBO RESTAURANT & BAR INC	Dominican
EL NUEVO PATIO RESTAURANT CORP	Dominican
El Nuevo Pollo Sabroso	Dominican
EL NUEVO SABOR CORP	Dominican
El Nuevo Sabor Restaurant	Dominican
El Nuevo Salinas Restaurant	Dominican
El Nuevo Salinas Restaurante	Dominican
El Nuevo Taino Restaurant Corp.	Dominican
EL NUEVO TENAMPA RESTAURANT	Mexican
El nuevo Tina Restaurant	Dominican
EL NUEVO VALLE SEAFOOD RESTAURANT CORP	Dominican
El Paisa Bar	Colombian
EL PAISANITO RESTAURANT CORP	Mexican
EL PALACIO DE EMPANADAS	Colombian
El Palo Bar & Restaurant Corp.	Dominican
El Palo Bar & Restaurant Inc	Dominican
El Parador Cafe	Mexican
El Pasillo	Mexican
EL PEDREGAL RESTAURANT CORP	Mexican
EL POLLO ENCHILADO CORP	Mexican
El Pollo Real	Peruvian
El Pollo Real Restaurant INC	Peruvian
El presidente II restaurant	Dominican
EL PUERTO DE ACAPULCO	Mexican
EL PUERTO DE ACAPULCO BAR RESTAURANT INC.	Mexican
EL PUNTO COLUMBIANO RESTAURANTE BAKERY	Colombian
El Quinto Pino	Spanish
El Ranchito de Daisy	Mexican
EL RANCHO LOS COMPADRES CORP	Mexican
El Rey Latino	Dominican
El Rey Restaurant	Mexican
El rinconcito de los sabores inc	Dominican
EL RINCONCITO PAISA RESTAURANT &amp; BAKERY	Colombian
EL RODEO	Mexican
EL SABOR DE LA ESQUINA	Mexican
EL SABOR LATINO	Dominican
EL SAJOMITA RESTAURANT	Mexican
EL SASON DE MI ABUELA	Mexican
EL SAZON DE OLGA RESTAURANT CORP	Dominican
El Super Chivito	Argentine
EL TEMERARIO	Mexican
El Tenampa Restaurant	Mexican
EL TIMBIRICHI RESTAURANT CORP.	Mexican
EL TIPICO RESTAURANT	Dominican
EL TORO BLANCO	Mexican
El Toro Bravo Testaurant	Mexican
El Trio	Dominican
El Valle Restaurant	Dominican
EL VAQUERITO	Mexican
El Vez	Mexican
El Vicentino Restaurant	Mexican
El Vicentino Restaurant 2	Mexican
El Viejo Jhons Restaurant	Dominican
EL VIEJO YAYO	Dominican
El viejo yayo 2	Dominican
El Viejo Yayo Restaurant	Dominican
EL ZOCALO GRILL	Mexican
ELA TAVERNA	Greek/Mediterranean
Elephant & Castle	British
Eleva Coffee	Cafe/Coffee
ELEVA COFFEE BAR	Cafe/Coffee
Elia Restaurant	Greek/Mediterranean
ELIO'S RESTAURANT	Italian
Ella Mozzarella	Italian
ELLEN'S STARDUST DINER	Diner
Elmo Restaurant	Italian
ELSA LA REINA DEL CHICHARON	Dominican
ELSEWHERE ESPRESSO	Cafe/Coffee
EMERALD INN	Irish
EMILIA'S RESTAURANT	Italian
EMILIO BALLATO'S	Italian
EmilioGCOs cucina	Italian
Emir Palace	Turkish
Emmett's	Pizza
Emmy Squared	Pizza
Empanada City	Colombian
Empanada Loca	Colombian
EMPANADA MAMA	Colombian
EMPANADAS EL GUSTAZO RESTAURANTE	Colombian
EMPANADAS MIX	Colombian
Empellon Al Pastor	Mexican
EMPIRE DINER	Diner
Empire Steak House	Steakhouse
emporio	Italian
ENOTECA MARIA	Italian
Enoteca On Court	Italian
ENZO'S RESTAURANT	Italian
ERIN MCKENNA'S BAKERY	Bakery
Erins isle	Irish
Erminia Restaurant Corporation	Italian
ESCAPE LATINO	Dominican
Espresso 77	Cafe/Coffee
Espresso Me	Cafe/Coffee
Ess-a-Bagel	Bagels
Estancia 460	Argentine
ESTIATORIO MILOS	Greek/Mediterranean
Estrella Bronx Resturant inc.	Dominican
ESTRELLA DO NORTE RESTAURANTE INC	Brazilian
ESTRELLA LATINA	Dominican
Estrellita Mixteca	Mexican
Estrellita Poblana	Mexican
Estrelllita Poblana	Mexican
Europan Cafe	Cafe/Coffee
European coffee bar	Cafe/Coffee
Evil Katsu	Japanese
EVIL TWIN BREWING	Bar/Pub
Extra Virgin	Italian
FABBRICA	Italian
Fabrique Bakery	Bakery
FAJITAS SUNRISE RESTAURANT CORP	Mexican
FANELLI CAFE	Cafe/Coffee
FANSWAY TERIAKYI KITCHEN	Japanese
FARO DEL PACIFICO PUPUSERIA & RESTAURANT	Salvadoran
Farrell's Bar and Grill	Bar/Pub
Farrells Bar & Grill	Bar/Pub
FAT CHOY	Chinese
FAVELA GRILL	Brazilian
Fayrooz Cafe	Lebanese
FAZIO'S	Italian
FEENEY'S PUB	Bar/Pub
Feile	Irish
FELICE	Italian
FELIX ROASTING CO.	Cafe/Coffee
FERRARA BAKERY & CAFE INC	Bakery
Fette Sau	BBQ
Fiaschetteria Pistoia	Italian
Fiddlesticks Pub & Grill	Bar/Pub
Fifth   Avenue Diner	Diner
Fin Du Monde	Belgian
Finback Brewery	Bar/Pub
FINNEGAN'S WAKE	Irish
Finnerty's	Irish
FINO	Italian
Fiona's Bar	Bar/Pub
Fish Bar	Seafood
Fish Cheeks	Thai
Fish Market	Seafood
FISH ON PARK	Seafood
Fitoor	Indian
Fitoor Cafe & Grill Lounge	Indian
Fitzgerald's Pub	Bar/Pub
Five Boroughs Brewing Co.	Bar/Pub
FLANNERY'S BAR	Bar/Pub
FLATBUSH LATIN GRILL	Caribbean
Flats fix	Israeli
FLE FLE Grill	Nigerian
Fleming By Le Bilboquet	French
FLEX MUSSELS	Seafood
FLIP SIGI	Filipino
Flor de Mayo	Dominican
FLOUR SHOP	Bakery
FLYING HIPPO BAKERY CAFE	Bakery
Fokkus Room & Cucine	Italian
Follia	Italian
FONDA	Mexican
FONDA GARIBALDI	Mexican
Fonda of Chelsea	Mexican
FOREVER COFFEE BAR	Cafe/Coffee
Forlini's Restaurant	Italian
FORNINO	Pizza
Forno Rosso	Italian
Fortunato Bros	Italian
Four & Twenty Blackbirds	Bakery
Four Four South Village	Taiwanese
FOUR FOUR SOUTH VILLAGE TAIPEI BEEF NOODLES	Taiwanese
Fourth Avenue Pub	Bar/Pub
Foxy Johns	Irish
Fragole Restaurant	Italian
Franchia Vegan Cafe	Vegan/Vegetarian
Frankie & Johnnie's Steakhouse	Steakhouse
Frankie and JohnnieGCOs Steakhouse	Steakhouse
Frankies 457 Spuntino	Italian
Franks Tavern	Bar/Pub
Fratelli	Italian
Fratelli Restaurant	Italian
FRAUNCES TAVERN	Bar/Pub
Fraunces Tavern Restaurant	Bar/Pub
FREDDY'S BAR	Bar/Pub
FRESCO	Italian
Fresco by Scotto	Italian
FRESCO ON THE GO	Italian
FRESCO Y RAPIDO	Dominican
FRESCO Y RAPIDO INC	Dominican
Fresco's Pizzera	Pizza
FRESH REMEDY HEALTH &amp; JUICE BAR	Juice/Smoothie
FRESH SMOOTHIES	Juice/Smoothie
Frida Tacos	Mexican
FRIEDMAN'S	American
FRIEDMAN'S RESTAURANT	American
FRIEDMANS	American
Friedmans Restaurant	American
FRIEND OF A FARMER	American
Friends Tavern	Bar/Pub
FU MUN LOU	Chinese
FU ZHI ZHOU INC	Chinese
fuji hana restaurant	Japanese
Fukurou	Japanese
FULL CIRCLE BAR	Bar/Pub
Fulton Ale House	Bar/Pub
FULTON CHICHARRONES	Dominican
Fumo Harlem	Italian
Fumo restaurant	Italian
FUNNY BBQ BAR	BBQ
FUSHIMI	Japanese
GABBY O'HARAS	Irish
GAL BI MA EUL	Korean
Galanga	Thai
Galaxy Diner	Diner
Galli	Italian
GALLO NERO	Italian
Galo Churrasqueira 2 llc	Portuguese
GAN-HOO BBQ	BBQ
GANEY ORLY	Israeli
GARNIC DINER &amp; CAFE	Diner
Gazala's Restaurant	Israeli
Gee Whiz Diner	Diner
Geisha Asian Fusion	Japanese
GELATERIA GENTILE	Ice Cream/Dessert
Gelso & Grand	Italian
GELTERIA GENTILE	Ice Cream/Dessert
GEMELLI	Italian
GEMINI DINER	Diner
Gemma	Italian
GEO SI GI	Korean
GERSI	Italian
GG'S FISH AND CHIPS	Seafood
GHANDI CAFE	Indian
Ghenet Brooklyn	Ethiopian
GIAN PIERO BAKERY	Bakery
Giano Restaurant	Italian
GIARDINO 54	Italian
GINA LA FORNARINA	Italian
Ginger & Lemongrass II LLC	Vietnamese
Ginger and Lemongrass	Vietnamese
GinoGCOs Pastry Shop	Bakery
Giorgio's of Gramercy	Italian
Giovanni's Brooklyn Eats	Italian
Girasol Bakery	Bakery
GLASS HOUSE TAVERN	Bar/Pub
glasserie	Greek/Mediterranean
Glendale Diner	Diner
GlenPatricks Pub	Bar/Pub
GMT TAVERN	Bar/Pub
GNOCCHERIA	Italian
GNOCCHERIA BY LUZZO'S	Italian
Gnocco	Italian
GO NONNA	Italian
Golden Diner	Diner
Golden Imperial Palace	Chinese
Golden Palace Gourmet, Inc.New	Chinese
Golden Unicorn Gourmet Corp	Chinese
GONZALEZ Y GONZALEZ	Mexican
GOOD STUFF JUICE COMPANY	Juice/Smoothie
Googongtan	Korean
Gopchang Story	Korean
Gopchang story flushing	Korean
GOSHT RESTAURANT	Indian
GOTTA GETTA BAGEL OF QUEENS	Bagels
Gotta Getta Bagel of Queens of NYC	Bagels
Gracie mews diner	Diner
GRADISCA	Italian
gran caffe de martini	Italian
GRAN CORONA DINER & GRILL	Diner
Gran Morsi	Italian
Gran Tivoli	Italian
Gran Torino	Italian
Grand Canyon Diner	Diner
Graziellas Restaurant	Italian
GRECA	Greek/Mediterranean
Greecologies	Greek/Mediterranean
GREENBERG'S BAGELS 2 LLC	Bagels
GREENPOINT FISH &amp; LOBSTER CO.	Seafood
GREGORY'S 26 CORNER TAVERNA	Greek/Mediterranean
Gregorys Coffee	Cafe/Coffee
Grill Point	Uzbek
Grilled Steak Corp. El Super Chivito	Argentine
Grimaldi's	Pizza
GRIND NYC COFFEE SHOP	Cafe/Coffee
Grotta Azzurra	Italian
GROUND CENTRAL COFFEE COMPANY	Cafe/Coffee
GROUNDED CAFE	Cafe/Coffee
GUACAMOLE MIDTOWN CORP	Mexican
GUACUCO	Venezuelan
GUACUCO BED-STUY	Venezuelan
Guadalajara de Dia No. 2 Corp.	Mexican
GUADALUPE BAR AND GRILL	Mexican
Guadalupe Inn	Mexican
Guadalupe Restaurant	Mexican
GUAJILLO RESTAURANT	Mexican
GUANTANAMERA	Cuban
Guantanamera Restaurant	Cuban
Gulchatay	Uzbek
GULSHAN TERRACE	Bangladeshi
GUNBAE	Korean
GUPSHUP	Indian
Gurman Restaurant	Russian
GUSTO LATINO CAFE REST 1	Dominican
GUSTOSO RESTAURANT	Italian
H & L Bagels, Inc.	Bagels
H CRAB	Seafood
HABANERO	Mexican
Hadramout Restaurant	Yemeni
Haenyeo	Korean
Haewoondae	Korean
Haizea	Spanish
HAKATA ZEN	Japanese
Hallal Sandwich Shop Inc	Deli
HAN DYNASTY	Chinese
HAN JOO BBQ CYCJ INC	Korean
HANA MAKGEOLLI	Korean
HANAMICHI	Japanese
HANBAT	Korean
HANBAT RESTAURANT	Korean
Handcraft Coffee	Cafe/Coffee
Hangawi	Korean
HAO NOODLE	Chinese
Hao Noodle and Tea LLC	Chinese
Hao Noodle LLC	Chinese
Happy veggie restaurant	Vegan/Vegetarian
HARBS	Japanese
HARBS Chelsea	Japanese
HAREFIELD ROAD PUB	Bar/Pub
HARLEM BURGER CO.	American
Harlem Shake	American
HARU	Japanese
Hasaki	Japanese
HasenStuble	German
Haveabagel	Bagels
haveli restaurant and lounge	Indian
Heidelberg Restaurant	German
Heights faladel	Israeli
hell's chicken	Korean
HELLCAT ANNIE'S TAP ROOM	Bar/Pub
HENO HENO	Mexican
HER NAME IS HAN	Korean
HEY YUET	Chinese
Hibernia Bar and Grill	Irish
HIGH VIBRATIONS JUICE BAR	Juice/Smoothie
Hill Country	BBQ
Hing Wong Restaurant Corp.	Chinese
Hiramasa Restaurant	Japanese
HIROHISA	Japanese
Ho Foods NYC	Taiwanese
Hog Pit NYC	BBQ
Hoja Santa Restaurant	Mexican
HOLLYWOOD DELIGHTS	American
Hometown Bar B Que	BBQ
HONEYBRAINS	Cafe/Coffee
HONG KONG BOY RESTAURANT	Chinese
Hong Kong kitchen	Chinese
Horus Kabab House	Indian
Hot N Juicy Crawfish	Seafood
HOT SPACE SZECHWAN RESTAURANT INC	Chinese
HOURGLASS TAVERN &amp; CAFE	Bar/Pub
Howard Beach Bagel Cafe	Bagels
HUASCAR &amp; CO BAKE SHOP	Bakery
hudson bagel	Bagels
HUDSON HOUND	Irish
HUDSON MALONE	Irish
Hudson Smokehouse	BBQ
HUDSON YARDS TAVERN	Bar/Pub
Huertas	Spanish
Humro Bhim's Cafe Inc	Nepali
HUNGRY GHOST	Cafe/Coffee
Hungry Ghost Coffee	Cafe/Coffee
Hunter's Steak & Ale House	Steakhouse
HYO DONG GAK	Korean
HYUN	Korean
I LOVE PANZEROTTI	Italian
I LOVE PANZEROTTI NY, LLC	Italian
I SODI	Italian
ICE CREAM HOUSE	Ice Cream/Dessert
ICE CREAM HOUSE ON 36	Ice Cream/Dessert
ICE CREAM HOUSE ON AVE M	Ice Cream/Dessert
Ichibantei	Japanese
IchiUmi	Japanese
IHAWAN	Filipino
IHOP	American
Il Brigante Restaurant	Italian
il Buco	Italian
IL BUCO ALIMENTARIVINERIA	Italian
IL CAFFE LATTE 2	Italian
IL CARINO RESTAURANT	Italian
Il Colosseo	Italian
IL Cortile Restaurant	Italian
Il Falco	Italian
Il Fiorista	Italian
IL GRADINO	Italian
IL MATTONE	Italian
IL MELOGRANO	Italian
IL MULINO	Italian
Il Mulino Prime	Italian
Il Piccolo Bufalo Restaurant	Italian
Il Poeta	Italian
IL POSTINO	Italian
Il Posto	Italian
IL POSTO ACCANTO	Italian
Il Punto	Italian
Il Sapore Cafe	Italian
Il sole restaurant	Italian
Il Violino	Italian
ilili	Lebanese
ILLY CAFFE	Cafe/Coffee
Inca Roaster Corp	Peruvian
incheon restaurant	Korean
INDAY	Indian
INDO CHINE	Vietnamese
Insa	Korean
INWOOD BAR AND GRILL	Bar/Pub
Ipanema Restaurant	Brazilian
Irie Bite inc	Jamaican
Irving Farm	Cafe/Coffee
Irving Farm Coffee	Cafe/Coffee
ISE RESTAURANT	Japanese
Isle of Capri	Italian
IzzieGCOs Cheesesteaks	American
IZZY'S BBQ MAHATTAN LLC	BBQ
J & G DINER	Diner
J A JAM DOWN CARRIBEAN RESTAURANT	Jamaican
J.J Kinahan's	Irish
Jack Demseys	Bar/Pub
JACK'S WIFE FREDA	Israeli
Jackson Hole Burgers	American
Jacob's Pickles	American
JAGALCHI CORP	Korean
Jajaja	Mexican
JAKE'S SALOON	Bar/Pub
JALAPENO KING	Mexican
Jamesons	Irish
JAMESONS BAR &amp; KITCHEN	Irish
Jamesons Pub	Irish
Janie's Life-Changing Baked Goods	Bakery
JAPAS NY	Japanese
Japonica	Japanese
Jax Inn Diner	Diner
JAZBA	Indian
Jean Claude restaurant	French
Jean Danet Pastry Shoppe	Bakery
Jeju Noodle Bar	Korean
JEJUDO	Korean
Jeong Yook	Korean
Jeremy's Ale House	Bar/Pub
JG Melon	American
JIA XIANG KITCHEN INC	Chinese
Jiang Diner	Chinese
JIANG HU XIAO CHUAN	Chinese
Jin Chao Bakery Inc	Bakery
Jin Feng Yuan	Chinese
Jin Noodle Inc	Chinese
Jing Fong Restaurant	Chinese
Jing Fu House	Chinese
JOE &amp; THE JUICE	Juice/Smoothie
JOE &amp; THE JUICE GREENWICH ST	Juice/Smoothie
JOE &amp; THE JUICE HUDSON ST	Juice/Smoothie
JOE COFFEE	Cafe/Coffee
JOE COFFEE COMPANY	Cafe/Coffee
Joe Coffee Waverly	Cafe/Coffee
Joe Jr. Restaurant	Diner
Joe's Ginger	Chinese
JOE: THE ART OF COFFEE	Cafe/Coffee
JOES STEAM RICE ROLL	Chinese
John Brown Smokehouse	BBQ
John Mulligans Fireside Pub	Irish
John's of Bleecker St	Pizza
JOHNNY MACK'S BAR	Bar/Pub
Johnny's Bar	Bar/Pub
Johns Deli	Deli
Joloff Restaurant 2	Nigerian
JONES WOOD FOUNDRY	British
JONGRO BBQ	Korean
Jook Sing	Chinese
Jora Restaurant & Bar	Peruvian
Jose Luis Little Italy	Italian
Josie Woods Pub	Bar/Pub
JUANCHIGCOS BURGERS BROOKLYN	American
Juice &amp; Tings	Juice/Smoothie
juice and joy organic coffee	Juice/Smoothie
JUICE GENERATION	Juice/Smoothie
Juice Press	Juice/Smoothie
JUICERY HARLEM	Juice/Smoothie
Jujube Tree	Vegan/Vegetarian
Juke Bar	Bar/Pub
Julia's Beer and Wine Bar	Bar/Pub
Julieta Restaurant	Mexican
Juliette	French
JUNCTION SEAFOOD RESTAURANT	Seafood
JUNE SING RESTAURANT	Chinese
Jungle Cafe	Cafe/Coffee
JUNGSIK	Korean
JUNIOR'S SEAFOOD	Seafood
JUNOON	Indian
Junzi Kitchen	Chinese
Juquila Restaurant	Mexican
JUST SALAD	Vegan/Vegetarian
K CAFE CORP	Cafe/Coffee
K Rico South American Steakhouse	Steakhouse
K Rico Steakhouse	Steakhouse
K TOP CHICKEN	Korean
K TOWN	Korean
K&L Delicatessen	Deli
K. SOPA DE CARACOL	Honduran
Kabab king	Pakistani
Kabisera	Filipino
Kafana	Serbian
Kaffe 1668	Cafe/Coffee
Kaffeine 231	Cafe/Coffee
Kahlo	Mexican
Kai Fan	Chinese
Kaieteur express	Caribbean
Kaieteur Restaurant & Sports Bar	Caribbean
KAIKAGETSU NYC	Japanese
kailash parbat	Indian
KALYE	Filipino
KAM HING CAFE	Chinese
KAME	Japanese
KANG TONG BBQ	Korean
Kanoyama Restaurant	Japanese
Kaoru restaurant	Japanese
KAPAMILYA	Filipino
KAPE'T TORTA	Filipino
Kappo Masa	Japanese
Karam Restaurant	Lebanese
Karazishi Botan	Japanese
Karczma Restaurant	Polish
KARIBBEAN KRAVE	Caribbean
Karvouna Mezze	Greek/Mediterranean
Kasbah Grill & BBQ	Moroccan
KASHKAVAL GARDEN	Greek/Mediterranean
Kashmir9	Indian
KATANA KITTEN	Bar/Pub
KATIE O'S	Irish
Kato Sake Works	Japanese
Katsuhama 55	Japanese
Katsuhama restaurant	Japanese
Katzs Delicatessen	Deli
KAUSA	Peruvian
Kavkaz Restaurant Inc	Georgian
KAYLEE'S CREAMERY	Ice Cream/Dessert
KAZUNORI	Japanese
Kazunori the Original Handroll Bar	Japanese
Ke Lai Le	Chinese
Keens Steakhouse	Steakhouse
Kefi Restaurant	Greek/Mediterranean
Keki Modern Cakes	Bakery
KELLARI TAVERNA	Greek/Mediterranean
Kelly's Tavern	Bar/Pub
KENKA	Japanese
KENT ALE HOUSE	Bar/Pub
KETTL TEA BOWERY	Cafe/Coffee
KETTLE OF FISH	Bar/Pub
KEUR COUMBA RESTAURANT	Senegalese
KGB BAR	Bar/Pub
KHAABAR BAARI	Bangladeshi
Khao Kang	Thai
Khao Nom	Thai
Khe-Yo	Laotian
Khiladi	Indian
KHUN NOO	Thai
Killarney Rose	Irish
Kimganae	Korean
King Solomon	Israeli
KIng Solomon Restaurant	Israeli
KING'S STREET COFFEE	Cafe/Coffee
KINGS BAR	Bar/Pub
Kings Co Imperial	Chinese
Kings Fried chicken	Fast Food
Kings of NYC slice	Pizza
Kirsh Bakery and Kitchen	Bakery
KISSAKI UWS	Japanese
Klinsrisuk	Thai
Klom Klorm	Thai
Klong	Thai
KNICKERBOCKER BAR &amp; GRILL	Bar/Pub
Koarali estiatorio	Greek/Mediterranean
Kobrick Coffee Co.	Cafe/Coffee
KOCHI	Indian
KOKO SEAFOOD SALAD GRILL INC	Seafood
KOKO WINGS	Korean
KOKORICO	Colombian
KOLIBA	Czech
kombit restaurant	Haitian
Komorebi Full House	Japanese
Kona Coffee and Company	Cafe/Coffee
KONBINI	Japanese
KONDITORI	Cafe/Coffee
KONG SIHK TONG	Chinese
Koo Koo Chicken	Korean
KOPITIAM	Malaysian
KORYODANG BAKERY & CAFE	Korean
Kos Kaffe	Cafe/Coffee
Kouzan	Japanese
KRISPY KREME DOUGHNUT	Bakery
Krolewskie Jadlo	Polish
Krolewskie Jadlo inc	Polish
KT FRIED CHICKEN	Korean
Kubeh	Israeli
KUIH CAFE	Malaysian
Kulu Desserts	Ice Cream/Dessert
KULUSHKAT	Israeli
Kura	Japanese
Kuro Kuma Espresso & Coffee	Cafe/Coffee
KYMA	Greek/Mediterranean
Kyma NYC	Greek/Mediterranean
L'ABEILLE	French
L'Accolade	French
L'adresse	French
L'ADRESSE NOMAD	French
L'Amico	Italian
L'Angeletto Restaurant	Italian
L'ANGOLO DELLA VILLETTA	Italian
L'ENTREE / LUCKY DRAGON	Chinese
L'IMPRIMERIE	French
L'imprimerie, LLC	French
La Adelita de Woodside Restaurant & Bar	Mexican
La Baraka	French
LA BARAKA RESTAURANT	French
LA BARCA RESTAURANT	Mexican
La Barista	Cafe/Coffee
La Bella vita	Italian
LA BERGAMOTE	French
LA BIENVENIDA RESTAURANT CORP	Dominican
La Bonanza Bakery	Bakery
LA BONNE SOUPE	French
La Boulangerie de Francois	French
La Brisa del Cibao	Dominican
LA BRUSCHETTA RESTAURANT	Italian
LA CALENITA	Colombian
La calenita bakery	Bakery
La Caleta Ecuatoriana	Ecuadorian
La carreta ecuatoriano restaurant	Ecuadorian
la casa de frida corp	Mexican
La Casa de los Antojitos	Mexican
La Casa Del Mofongo 207 LLC	Puerto Rican
La Casa Del Mofongo Inc	Puerto Rican
la casa del mofongo llc	Puerto Rican
La Caverna	Italian
La Chacra Restaurant Inc	Peruvian
LA CHACRA RESTAURANT INC.	Peruvian
LA CHILAQUERIA NEW YORK	Mexican
La Chula	Mexican
LA CHURRERIA	Spanish
La Cigogne	French
La cocina de alex	Mexican
La Compagnie des Vins Surnaturels	French
La Coneja Juice Bar	Juice/Smoothie
La Contenta	Mexican
La Contenta Next Door	Mexican
La Contenta Oeste	Mexican
LA CONTRADA	Italian
LA CUEVA FONDA RESTAURANTE	Mexican
LA DEVOZIONE	Italian
LA DULCE BAKERY	Bakery
La Espanola Way Inc	Spanish
La Espiga 3 Estrellas	Mexican
La Espiga Restaurant and Bakery Corp.	Mexican
La Esquina	Mexican
La Esquina de Nagua	Dominican
La Esquina Del Sabor	Mexican
La Estrella del castillo restaurant	Mexican
La Fe Bakery & Coffee Shop	Bakery
La Flor de Izucar Bakery Inc	Bakery
La Flor Restaurant & Cafe	Mexican
La Flor Restaurant and Cafe	Mexican
La fogata restaurant & cafe corp	Mexican
LA FUENTE STEAK HOUSE CORP.	Steakhouse
La Fusta Restaurant	Argentine
La Goulue 61 LLC	French
La Goulue 61, LLC	French
LA GRAN PARADA	Dominican
La Grenouille	French
La grotta di marcello	Italian
La Guadalupe Restaurant Corp.	Mexican
La Hueca	Ecuadorian
LA HUECA GUAYACA CORP	Ecuadorian
LA LECHONERA CRIOLLA INC	Puerto Rican
La Locanda Inc.	Italian
LA LOTERIA	Mexican
LA MASSERIA	Italian
LA MELLAS RESTAURANT	Dominican
La Mercerie	French
LA MESITA	Mexican
LA NACIONAL	Spanish
La Nonna Restaurant	Italian
La nueva amistad bakery and restaurant corp	Bakery
LA NUEVA BAKERY	Bakery
La Nueva Caricias Restaurant inc	Dominican
La Nueva Espana	Spanish
La Nueva Noventa Bakery	Bakery
La Palapa	Mexican
LA PALMA RESTAURANT  INC	Dominican
La Panineria	Italian
LA PARADA RESTAURANT	Dominican
La Parisienne	French
LA PARRANDA	Dominican
La Patrona Restaurant Corp	Mexican
LA PECORA BIANCA	Italian
La Pecora Bianca NoMad	Italian
La Perla Del Ulua Restaurant Inc	Honduran
La Pollera Colorada II	Colombian
La pollera coloradaII	Colombian
la pollera de Mario	Colombian
La Puerta Roja	Mexican
LA PULPERIA 44	Peruvian
LA QUEEN TEA HOUSE INC	Cafe/Coffee
La Rioja Restaurant	Spanish
La Ripaille	French
La roja de todos restaurant & bakery	Bakery
LA ROLA RESTAURANT	Colombian
LA ROTISSERIE DU COIN	French
LA SANDWICHERIE	French
LA SAVANE D' AFRIQUE	Senegalese
LA SHUK	Israeli
La Sirene UWS	French
La Sultana cafe	Cafe/Coffee
LA TRONCALENA RESTAURANT	Honduran
La Unica panaderia	Bakery
La Vara	Spanish
La Vecina	Mexican
La Vigna Restaurant and Bar	Italian
LA VILLETTA	Italian
LABAGEL DELIGHT	Bagels
Laduree	French
LADUREE PARIS	French
LADUREE SOHO	French
Lafayette Grand Cafe & Bakery	French
Lagman house	Uzbek
Lahore Broast Inc	Pakistani
Lakou Cafe	Haitian
Laliguras	Nepali
Lamia's Fish Market	Seafood
Lamoon	Thai
lan larb soho	Thai
LAN SHENG RESTAURANT	Chinese
LAO MA SPICY	Chinese
LaRina Pastificio & Vino	Italian
Las Americas Bakery	Bakery
Las Chelitas	Mexican
las chilangas	Mexican
LAS DELICIAS RESTAURANT &amp; BAKERY	Bakery
Las Margaritas Astoria	Mexican
Las Margaritas Restaurant &Bar	Mexican
Las Margaritas Restaurant and Sports Bar	Mexican
Las Palmas Bakery LLC	Bakery
Las Palmas Dominuicanas	Dominican
Las Palmas Restaurant II Inc	Dominican
Las Panteras Negras Restaurant	Mexican
LAS PATRONAS BAR AND RESTAURANT	Mexican
Las Ramblas	Spanish
Las Santas	Mexican
LAS TIAS BAKERY CAFE	Bakery
Las' Lap	Trinidadian
LaSalle Bakery	Bakery
LASSEN &amp; HENNIGS	Deli
Latin Bakery	Bakery
Latin Cabana	Caribbean
LATINO BITES	Caribbean
Laughing Man Coffee	Cafe/Coffee
Laut	Malaysian
Lavagna	Italian
Le Baba Cool, Inc	French
LE BARATIN	French
LE BATEAU IVRE	French
LE BILBOQUET	French
Le Botaniste	Vegan/Vegetarian
Le cafe coffee	Cafe/Coffee
LE CHARLOT	French
LE CHEILE	Irish
LE DIZE	French
Le gamin	French
Le Garage	French
Le Gigot	French
Le Grainne Caf+?	French
LE LABO CAFE	Cafe/Coffee
Le Marais	French
LE MISTRAL	French
LE MIU CORP	French
Le Monde	French
Le Moulin a Cafe NYC	French
LE MXICANO	Mexican
Le Paddock	French
LE PAIN QUOTIDIEN	French
Le Pain Quotidien - Bryant Park	Bakery
Le Pain Quotidien - Carnegie Hill	Bakery
Le Pain Quotidien 53rd street	Bakery
Le Pain Quotidien 83rd Street	Bakery
Le Pain Quotidien 97th and Mad	Bakery
Le Pain Quotidien First Ave and 68th	Bakery
Le Pain Quotidien GCW	Bakery
Le Pain Quotidien Madison	Bakery
Le Pain Quotidien Soho	Bakery
Le Pain Quotidien Tribeca	Bakery
le Parisien	French
Le Petit Parisien	French
LE PHIN	Vietnamese
Le Prive	French
Le Rivage	French
Le Sajj Restaurant	Lebanese
Le Sia	Thai
le singe vert	French
Le Souk Restaurant	Moroccan
Le Succulent	French
Le Zie 2000	Italian
Lead by Example & Reverse the Trend, Inc., DBA Legends House of Seafood	Seafood
Lean Crust	Pizza
Lechon Hornado Ecuatoriano Corp	Ecuadorian
LECHONERA EL FOGON	Puerto Rican
lechonera pollo sabroso	Puerto Rican
LECHONERA Y EL POLLO SABROSO RESTAURANT INC	Puerto Rican
Lee's Tavern	Bar/Pub
LEFKOS PYROS	Greek/Mediterranean
LEGENDS TAVERN	Bar/Pub
LELIS BAKERY AND PASTRY SHOP	Bakery
Lella Alimentari	Italian
Lemongrass Grill	Thai
Lennys clam bar	Seafood
Lenox Coffee	Cafe/Coffee
LENWICH	Deli
LENWICH 68TH	Deli
LeoGCOs Restaurant and Sports Bar	Bar/Pub
Leonelli Focacceria e Pasticceria	Italian
LES AMBASSADES	French
LES AMIS CAFE INC.	French
Les Deux Chats	French
Let's Meat	Korean
Lettuce Eat	Vegan/Vegetarian
LEVAIN BAKERY	Bakery
LEVANT ON SMITH	Lebanese
Lexington Candy Shop	American
LEYLA	Turkish
Lhasa Fast food	Nepali
Lhasa Fresh Food	Nepali
LHASA TIBET RESTAURANT AND BAR	Nepali
LIANJIANG RESTAURANT	Chinese
LIBERTY BAGEL MIDTOWN	Bagels
LIBERTY DINER	Diner
Liberty Soul Food Inc	American
Liberty Tavern	Bar/Pub
LIBRAE BAKERY	Bakery
LIC BAR	Bar/Pub
Lil Frankie's	Italian
Lil FrankieGCOs	Italian
LILI AND LOO	Chinese
Lima 33	Peruvian
Lima Restaurant	Peruvian
Limoncito Con Ron	Dominican
LIMOSNEROS	Mexican
Listo el chimi	Dominican
Little Alley	Chinese
LITTLE ATHENS NY	Greek/Mediterranean
Little Basil	Thai
LITTLE COLLINS	Cafe/Coffee
little cupcake bakeshop	Bakery
Little Dokebi	Korean
Little Forno	Italian
Little Tiffin	Burmese
LLAMA INN	Peruvian
LLAMA SAN	Peruvian
lobster house	Seafood
Lobster Joint	Seafood
LOCANDA BORBONI	Italian
Locanda Mariella	Italian
Locanda Verde	Italian
Locanda Vini e Olii	Italian
LOCKSMITH BAR	Bar/Pub
Loi Estiatorio	Greek/Mediterranean
lokanta	Turkish
LOLA SEAFOOD	Seafood
LOLA TAVERNA	Greek/Mediterranean
LoLo's Seafood Shack	Seafood
Lombardi's	Pizza
London Lennies	Seafood
Lonestar Bar & Grill	American
LONESTAR bar and grill	American
Long King House	Chinese
LOOK by Plant Love House	Thai
LOQMA CAFE	Turkish
Loreley Restaurant	German
Loreto Kitchen &amp; Bar	Italian
Los  primo restaurant	Mexican
Los 3 potrillos Express corp	Mexican
Los Andes	Peruvian
Los Angelitos Bakery Corp	Bakery
Los Arrieros	Colombian
LOS BALBUENA RESTAURANT CORP	Mexican
LOS CAFETALES RESTAURANT	Mexican
LOS CAFETALES RESTAURANT CORP	Mexican
LOS CATRACHOS	Honduran
Los Cuencanitos Restaurant	Ecuadorian
LOS DOS HERMANOS	Mexican
Los Girasoles Restaurant	Mexican
Los Mariscos	Mexican
Los Muchachos Restaurant Corp	Mexican
Los Tacos Al Pastor	Mexican
LOS TACOS MCONDO	Mexican
Los Tacos No.1	Mexican
Los tacos NYC LLC	Mexican
Los Toldos Restaurante	Peruvian
LOS TRES HERMANOS POTRILLOS INC	Mexican
LOS TRES POTRILLOS RESTAURANT BAR INC	Mexican
Los tres potrillos y.v inc	Mexican
LOUKOUMI TAVERNA	Greek/Mediterranean
LOULOU	French
LOVE MAMA	Thai
Loving Hut	Vegan/Vegetarian
LUCALI	Pizza
Lucciola	Italian
Lucky Chen	Chinese
LUCKY DOG	American
LUCY'S VIETANAMESE	Vietnamese
ludlow coffee supply	Cafe/Coffee
LUGO LOUNGE & RESTAURANT	Italian
Luke Kellys Bar	Bar/Pub
Luke's Lobster	Seafood
LUNA CAFE	Cafe/Coffee
Lupa restaurant	Italian
LUPE'S EAST L.A. KITCHEN	Mexican
LUPITA VILLA CORP.	Mexican
LUPO ROSSO	Italian
LURE FISHBAR	Seafood
Lusardi's	Italian
LUZ DE LUNA CAFE RESTAURANT INC	Mexican
LUZZO'S	Pizza
Luzzos bk	Pizza
M Tea	Cafe/Coffee
M. Wells Steakhouse	Steakhouse
MABAT STEAKHOUSE	Steakhouse
Mable's Smokehouse and Banquet Hall	BBQ
Mac's Public  House	Bar/Pub
MACARON COFFEE BAR	Cafe/Coffee
MACARON PARLOUR	French
Macchiato	Cafe/Coffee
Macchiato Espresso Bar	Cafe/Coffee
Mad for chicken	Korean
MAD FOR CHICKEN FOREST HILLS	Korean
MADAME BONTE	French
Madame Vo	Vietnamese
Madangsui	Korean
Madden's Pub	Bar/Pub
Madman Espresso	Cafe/Coffee
MADRE Restauant	Mexican
MADRE Restaurant	Mexican
Maggie Mae's Bar	Bar/Pub
MAGNOLIA BAKERY	Bakery
Maharaja Food Inc.	Indian
Mahzedahr Bakery	Bakery
Maialino	Italian
Maiella	Italian
Mainstreetbagels	Bagels
Maison Harlem	French
MAISON HARLEM RESTAURANT	French
Maison Pickle	American
Maison Yaki	Japanese
Maizal Restaurant	Mexican
MAJESTIC DELICATESSEN CAFE	Deli
MAKE MY CAKE	Bakery
Maki Kosaka	Japanese
MALA PROJECT	Chinese
Malai	Indian
MALAI MARKE	Indian
Malaparte	Italian
Malecon Restaurant	Dominican
Malibu Diner	Diner
MALII	Thai
Mally's Deli & Grocery corp.	Deli
Mallys'DELI Grocery CORP	Deli
Malt & Mold	Bar/Pub
MAMA CAPRI	Italian
MAMA G AFRICAN KITCHEN II	Nigerian
MAMA MECHO POLLOS A LA BRASA	Peruvian
MAMA'S HAND NOODLE	Chinese
Mamajuana Cafe	Dominican
MAMAN	Cafe/Coffee
MAMO RESTAURANT	Italian
Manducatis Rustica	Italian
Mango Mango Desert	Ice Cream/Dessert
MANGO MANGO DESSERT	Ice Cream/Dessert
MANGOMANGO DESSERT	Ice Cream/Dessert
MANGU GRILL RESTAURANT	Dominican
Manhattan Diner	Diner
MANHATTANVILLE COFFEE	Cafe/Coffee
MANOR OKTOBERFEST FOREST HILLS	German
MANOUSHEH	Lebanese
MAPO B.B.Q	Korean
Mar Y Tiera Restaurant & Lounge	Seafood
Marani Restaurant	Georgian
MARATHON COFFEE	Cafe/Coffee
Marble Dessert Bar	Ice Cream/Dessert
Marcellino Restaurant	Italian
Marea	Italian
MAREZZATA	Italian
Margherita NYC	Pizza
Margon Restaurant	Cuban
Mari Vanna	Russian
Maria Bonita Bakery Juice Bar	Bakery
Mario's Restaurant	Italian
MARISCO CENTRO	Seafood
Markjoseph steakhouse	Steakhouse
Marseille	French
MARTA	Italian
MARTHA'S COUNTRY BAKERY	Bakery
MarthaGCOs Country Bakery	Bakery
Marumi Corporation	Japanese
MARUZZELLA	Italian
Mary's Fish Camp	Seafood
Maryanns 353 Mex Inc	Mexican
Masal Cafe & Lounge	Turkish
Mashallah Grill Inc	Turkish
Massawa	Eritrean
Masseria Caffe and Bakery	Italian
Masseria Dei Vini	Italian
MATCHAFUL	Cafe/Coffee
MATIZ LATIN CUISINE	Colombian
MATSUNOYA	Japanese
MATTO ESPRESSO	Cafe/Coffee
MAX  CAFFE	Cafe/Coffee
MAX SOHA	Italian
May Kaidee East Broadway	Thai
MAY WAH PORK CHOP FAST FOOD	Chinese
Maz Mezcal, Inc	Mexican
Mazzola Bakery	Bakery
McCann's Pub & Grill	Bar/Pub
McDonald's	Fast Food
McDonald's Restaurant of New York INC.	Fast Food
McDonaldGCOs	Fast Food
McDonalds	Fast Food
McHale's Bar & Grill	Bar/Pub
MCM COFFEE	Cafe/Coffee
McSorleyGCOs Old Ale House Inc.	Bar/Pub
MEDAN PASAR	Malaysian
MEDITERRANEO	Greek/Mediterranean
Mee Noodle Shop	Chinese
MEET FRESH	Taiwanese
MeetFresh	Taiwanese
Mei Wei Si	Chinese
Mei Wei Si Restaurant	Chinese
mekong restaurant	Vietnamese
Mel's Burger Bar	American
Melt Shop	American
MeMe's Diner	Diner
MENKOI SATO	Japanese
Menkoisato	Japanese
MERCADO LA MERCED NYC	Mexican
mercato	Italian
MERCURY BAR	Bar/Pub
Merguez & Frite	French
MERMAID OYSTER BAR	Seafood
Mesa Coyoacan	Mexican
Metate	Mexican
Metro Diner	Diner
MEXICOCINA AGAVERIA	Mexican
Mexicoma	Mexican
Mexicue	Mexican
Mextec Restaurant Inc	Mexican
MEYHANE	Turkish
Mezbani Sweets & Restaurant	Bangladeshi
Meze	Greek/Mediterranean
MEZZANOTTE STATEN INSLAND	Italian
MEZZE	Greek/Mediterranean
MI BELLA DAMA RESTAURANT	Mexican
MI CASA RESTAURANT	Mexican
MI Paso Centroamericano Corp.	Guatemalan
Mi Pueblito	Mexican
Mi Pueblito Corp1	Mexican
Mi Romance Ecuatoriano	Ecuadorian
Michaelangelo's Brick Oven Restaurant	Italian
Michel Cluizel	French
MICHELADA HOUSE REST	Mexican
Mighty Quinn's Barbeque	BBQ
Mighty Quinn's BBQ	BBQ
MIKAKU	Japanese
Mike's Deli	Deli
Mike's Deli/Arthur Avenue Caterers	Deli
MIKE'S OAKWOOD DINER	Diner
Milk & Honey Cafe	Cafe/Coffee
MILK AND CREAM BAR	Ice Cream/Dessert
Milk Bar	Bakery
MILK BAR NOLITA	Bakery
Milkflower	Pizza
Mille-feuille Bakery	Bakery
MillerGCOs Ale House	Bar/Pub
Mimi Cheng's	Taiwanese
Minca	Japanese
MINETTA TAVERN	French
MING XING BBQ INC	Chinese
Mini Picanteria El Guayaquileno	Ecuadorian
Mirch	Indian
MIRIAM	Israeli
Miriam Restaurant	Israeli
Misi	Italian
MISO-YA	Japanese
MISS FAVELA	Brazilian
Miss Lily's	Jamaican
Miss Lily's 7A	Jamaican
Miss Madeleine	French
missKorea BBQ	Korean
Mitad Del Mundo Bar Restaurant	Ecuadorian
Miti Miti	Mexican
MITOUSHI	Japanese
Mixtec Restaurant	Mexican
Mocha Burger	American
MOCHA MOCHA COFFEE	Cafe/Coffee
Modern Bread & Bagel / Arba	Bagels
mofongo del valle restaurant	Puerto Rican
Mofongo el mocano restaurant	Puerto Rican
MOGE TEE	Taiwanese
Mokja Corp	Korean
Mole	Mexican
MOLINO ROJO RESTAURANT	Mexican
Molly's	Irish
Momochai	Japanese
MOMOFUKU NOODLE BAR	Japanese
Momofuku Ssam Bar	Japanese
Momokawa	Japanese
MOMOYA	Japanese
MOMOYA CHELSEA	Japanese
MOMOYA SOHO	Japanese
Mon Amour Coffee & Wine Inc.	Cafe/Coffee
Montesacro	Italian
Moo Burger	American
Mooncake Foods	Chinese
Moonrise Bakehouse	Bakery
Moot Bar	Bar/Pub
MOOYAH BURGERS	Fast Food
Morandi	Italian
MORGAN'S BBQ	BBQ
MORRONE PASTRY SHOP &amp; CAFE	Bakery
Morton's The Steakhouse 5th Ave	Steakhouse
Moti Mahal Delux	Indian
Motorino	Pizza
Moustache	Lebanese
MR N SEAFOOD	Seafood
MR. MARIO POLLOS A LA BRASA INC.	Peruvian
Mr. Soon Tofu	Korean
Mr.pollo #1	Peruvian
Ms Yoo	Korean
Mumtaz Indinan Cusine	Indian
MUNCHEN BAR &amp; GRILL	German
Murphy's Tavern	Bar/Pub
Murphys Pub and Restaurant	Bar/Pub
MURRAY'S BAGELS	Bagels
Murray's Bagels Chelsea	Bagels
MURRAY'S CHEESE	Deli
Murrays Cheese Bar	Deli
MUSE CAFE	Cafe/Coffee
MUSEUM OF ICE CREAM	Ice Cream/Dessert
Museum of Ice Crearm	Ice Cream/Dessert
Mustang Thakali Kitchen	Nepali
Mykonos Blue	Greek/Mediterranean
MYTHOS RESTAURANT	Greek/Mediterranean
Myungsan	Korean
NABABI RESTAURANT	Bangladeshi
NACHO MACHO TACOS	Mexican
Nadezhda	Russian
NAGLE'S BAGELS	Bagels
Naidre's Cafe	Cafe/Coffee
Nam Son	Vietnamese
Namaste Astoria	Indian
NAMI NORI	Japanese
NAMKEEN	Indian
NANCY WHISKEY PUB	Bar/Pub
Nangman BBQ	Korean
NapoleonGCOs Southern Cuisine and Bakery	American
Nargila Grill	Israeli
Nargis Corp.	Uzbek
natsumi	Japanese
NAYA	Lebanese
Neapolitan Express	Pizza
NEEROB RESTAURANT	Bangladeshi
Negril BK	Jamaican
NegrilBKCooks	Jamaican
NEIL'S COFFEE SHOP	Cafe/Coffee
Neirs Tavern	Bar/Pub
NELLO	Italian
Nelore Grill	Brazilian
NEPTUNE DINER	Diner
Nerai	Greek/Mediterranean
NEW CHOI FOOK RESTAURANT	Chinese
New Double Dragon By Lin	Chinese
NEW GOURMET MAYLIN	Chinese
New Grand Buffet	Chinese
New Lake Pavilion Restaurant	Chinese
New Maurice Deli	Deli
New Pinang Cuisine	Malaysian
NEW RUAN'S RESTAURANT CORP	Chinese
New toasties deli	Deli
NEW TU DO RESTAURANT	Vietnamese
new wonjo	Korean
New York Bakery Cafe	Bakery
NEW YORK BURGER CO.	American
new york canton lounge	Chinese
New York City Bagel and Coffee House	Bagels
New York Luncheonette	Diner
Nha Trang One Restaurant	Vietnamese
Nice Matin	French
Nino's Restaurant	Italian
NIPPON CHA	Japanese
Nipppon Cha	Japanese
nish nush	Israeli
Nisi	Greek/Mediterranean
Nisi Estiatotio	Greek/Mediterranean
Nisi NYC	Greek/Mediterranean
Nizza	Italian
No. 1 Calle 191 Pescaderia Inc.	Dominican
NO.1 CALLE 191 PESCADERIA	Dominican
Nobu Downtown	Japanese
Nocciola Pizzer+?a & Tratoria	Italian
NOCELLO	Italian
Noche De Margaritas Restaurant	Mexican
noches de palenque	Mexican
Noi Due	Italian
Noi Due Carne	Italian
NOI DUE INC	Italian
NOLITA COFFEE NYC	Cafe/Coffee
NOM WAH	Chinese
Nom Wah Tea Parlor	Chinese
NON LA	Vietnamese
Non Solo Piada	Italian
Nonna Beppa	Italian
Nonna Delias	Italian
NONNAS 1977	Italian
Nonnas 1977 LLC	Italian
Nonnas1977	Italian
Noodle Village	Chinese
Norbu lingkhas kitchen	Nepali
Noreetuh Restaurant	Hawaiian
NORIKOH	Japanese
NORMA	Italian
Norma gastronomia Siciliana	Italian
north miznon	Israeli
Northside Bakery	Bakery
NOSTRAND  SOCIAL	Bar/Pub
NOSTRAND SOCIAL	Bar/Pub
NOVITA	Italian
NOW OR NEVER COFFEE	Cafe/Coffee
NOWHERE BAR LOUNGE RESTAURANT INC	Bar/Pub
NOWON	Korean
Nuevas Brisas del Valle	Dominican
NUEVO DON FRANCISCO RESTAURANT	Mexican
Nuevo Don Francisco Restaurant Corp	Mexican
Nuevo Don Francisco Restaurant Corp.	Mexican
Nuevo Esmeralda's Restaurant Corp.	Mexican
Nuevo M+?xico Bar Restaurant	Mexican
Nuevo Rancho Latino Restaurant, Inc.	Mexican
Nuevo Shalon Restaurant Corp	Mexican
NUEVO TACOS AL SUADERO	Mexican
NUM PANG KITCHEN	Cambodian
Num Pang Sandwich Shop	Cambodian
Numero 28	Pizza
Nurnberger Bierhalle	German
Nutripan	Bakery
NY FISH HOUSE &amp; CRISPY CHICKEN	Seafood
NY Pao de Quiejo	Brazilian
NYC Famous Chicken	American
NYCS FRIED CHICKEN	American
O'DONOGHUE'S	Irish
O'Flanagan's Bar & Grill	Irish
O'Henry's Publick House	Bar/Pub
O'Neill's of Maspeth	Irish
O-MAI	Vietnamese
OAK TUSCAN TRUFFLE LOUNGE	Italian
Oasis bagel cafe g	Bagels
Obao	Vietnamese
Obica Mozzarella Bar	Italian
Oceanic Boil	Seafood
ODA HOUSE	Georgian
Offside Tavern	Bar/Pub
OFRENDA	Mexican
Oh taisho	Japanese
OHanlons	Irish
Oiji	Korean
OITA	Japanese
OKONOMI	Japanese
old homestead steakhouse	Steakhouse
OLD JOHN'S LUNCHEONETTE	Diner
OLD TOWN BAR &amp; RESTAURANT	Bar/Pub
OLD XI'AN DELICACIES	Chinese
Olio e Piu	Italian
OLIVER COFFEE	Cafe/Coffee
Ollie	Chinese
Ollies Noodle Shop & Grille	Chinese
Olympia Wine Bar	Bar/Pub
OM JUICE BAR	Juice/Smoothie
OM NAMASTE	Indian
Omai	Vietnamese
Omonia Cafe	Greek/Mediterranean
OOTOYA	Japanese
Ootoya Chelsea	Japanese
ORCHARD GROCER	Vegan/Vegetarian
Oren's Daily Roast	Cafe/Coffee
Oren's Daily Roast aka Oren's Coffee	Cafe/Coffee
Organic Grill	Vegan/Vegetarian
Osamil	Korean
Ottava	Italian
Outback Steakhouse	Steakhouse
Ovelia	Greek/Mediterranean
Ovelia Restaurant	Greek/Mediterranean
OVENLY	Bakery
OVEST PIZZOTECA	Pizza
Oxomoco	Mexican
P J Horgan's	Irish
P. J. Horgan's	Irish
PACIFIC PALACE	Chinese
Paddy Duggan's  Pub	Irish
Paesanos Restaurant	Italian
Page plaza diner	Diner
paladar restaurant	Cuban
Palo Santo	Peruvian
PAN TODO RICO	Bakery
Panaderia Coatzingo	Mexican
Panca	Peruvian
Panchitas Pace	Peruvian
Panchitas Place	Peruvian
Pancho Villa Restaurant Inc	Mexican
PANEANTICO BAKERY	Bakery
Panela bakery	Bakery
PANERA BREAD	Fast Food
PANETINO BAKERY	Bakery
Panorama Restaurant	Greek/Mediterranean
Papatzul	Mexican
papaya dog	Fast Food
PAPAZZIO RESTAURANT	Italian
Pappadella	Italian
Paratha Wala Inc.	Indian
PARIS BAGUETTE	Bakery
PARIS BAGUETTE CAFE	Bakery
PARIS CAFE	French
PARIS EATERY	French
Paris Oven	Bakery
PARIS OVEN BAKERY	Bakery
Paris Oven Inc	Bakery
PARISCIEN BAKERY	Bakery
Parisienne Cafe	Cafe/Coffee
Park Avenue Tavern	Bar/Pub
PARK BAR	Bar/Pub
Park Slope Ale House	Bar/Pub
Parkside Pub	Bar/Pub
Parkway Diner	Diner
PARM	Italian
PARMA NUOVA	Italian
Parnells Pub	Bar/Pub
Partners Coffee	Cafe/Coffee
Partybus Bakeshop	Bakery
PASQUALE JONES	Italian
Pasquale's Rigoletto Restaurant	Italian
PASTAI	Italian
pastelillos house & deli	Puerto Rican
Pasteur Grill & Noodles	Vietnamese
Pastis	French
Pastrami Queen	Deli
PASTRIZIAS OF MASPETH	Italian
PASTRY WORLD BAKERY	Bakery
PATACON PISAO	Venezuelan
Pate Palo	Dominican
Patent Coffee	Cafe/Coffee
Pates et traditions	French
PATIS BAKERY	Bakery
Patrizia's of Woodlawn	Italian
Patrizias of Brooklyn	Italian
Patrizias of sheepshead bay	Italian
PATSY'S PZZERIA	Pizza
patsys of queens, llc	Italian
PATZERIA FAMILY &amp; FRIENDS	Pizza
Paul's Da Burger Joint	American
Paulie Gee's	Pizza
Paulie Gee's Slice Shop	Pizza
Pazza Notte	Italian
PEACEFOOD CAFE DOWNTOWN	Vegan/Vegetarian
Peaches Shrimp & Crab	Seafood
Peachwave Frozen Yogurt	Ice Cream/Dessert
Peachwave Frozen Yogurt LLC	Ice Cream/Dessert
Pearl Oyster Bar	Seafood
Peculier Pub	Bar/Pub
PEE DEE STEAK	Steakhouse
Pelicana Chicken	Korean
Pencil Factory Bar	Bar/Pub
PEPE GIALLO	Italian
PEPE ROSSO TO GO	Italian
PEPEROSSO TO GO	Italian
peppinos brick oven	Pizza
Pera	Turkish
Pera Soho	Turkish
Periyali	Greek/Mediterranean
PERRY'S COFFEE SHOP	Cafe/Coffee
Pescada	Seafood
Pescada New York	Seafood
Pescatore Restaurant	Italian
Peter Luger Steak House	Steakhouse
PETES TAVERN	Bar/Pub
Petisco Vegano	Vegan/Vegetarian
Petite Boucherie	French
Petite Crevette	French
Petrarca	Italian
piacere	Italian
PIATTO LIC	Italian
PICANTE	Mexican
Picante Picante	Mexican
PICANTERIA EL AUSTRO	Ecuadorian
PICCIOTTO SICILIAN STEER FOOD&amp;CAFE	Italian
Piccola cucina Estiatorio	Italian
Piccola cucina Uptown	Italian
Piccolino Restaurant	Italian
Piccolo Cafe	Italian
Pick A Bagel	Bagels
Pickabagel	Bagels
Pico De Gallo Restaurant	Mexican
Pierozek	Polish
PIERRE LOTI MIDTOWN	Turkish
PIERRE LOTI WINE BAR & CAFE	Turkish
Pies 'n' Thighs	American
PIES-N-THIGHS	American
Pietro Nolita	Italian
PIG &amp; BUTTER	American
Pig and Khao	Filipino
Pig Beach BBQ	BBQ
pig n whistle	Irish
Pig n Whistle 36th ST	Bar/Pub
Pink Nori	Japanese
pino wine bar	Italian
Pinos la forchetta	Italian
Pinto Garden	Thai
Pinto Restaurant	Thai
PIO PIO	Peruvian
Pio Pio Ocho Inc.	Peruvian
Pio Pio Restaurant	Peruvian
Pio Pio Restaurant Inc	Peruvian
pipins pub	Bar/Pub
PIPPALI	Indian
PIROSMANI RESTAURANT	Georgian
Pisticci Restaurant	Italian
PITALLAS I CORP BLUE TIJUANA	Mexican
Pizzette	Pizza
PLANTA QUEEN	Vegan/Vegetarian
PlantShed Cafe	Cafe/Coffee
Playa Betty's	Mexican
PLAYA BOWLS	Juice/Smoothie
PLAYGROUND COFFEE SHOP	Cafe/Coffee
Playwright celtic pub	Bar/Pub
Playwright tavern	Bar/Pub
Plum Tomatoes by La Sorrentina	Italian
Pocha 32	Korean
Polanco's Restaurant	Mexican
Pollo Campero	Guatemalan
Pollo D' Oro	Peruvian
Pollos a la Brasa Mario	Peruvian
Pollos a la Braza Mario	Peruvian
Pollos Mario	Peruvian
Pollos Mario Restaurant	Peruvian
Pollos Mario Woodhaven	Peruvian
POLLOS NAPOLES	Peruvian
POLONICA RESTAURANT	Polish
POLPETTE 71	Italian
Pommes Frites	Belgian
POMO	Italian
PONTE VECCHIO	Italian
Popeyes	Fast Food
Pops deli	Deli
Porsena	Italian
Portale Restaurant	Italian
Porte+?as	Argentine
Porteno	Argentine
Portici Restaurant Inc.	Italian
Porto Salvo	Italian
PORTOFINO	Italian
POSITANO	Italian
Postmark Cafe	Cafe/Coffee
Poulette rotisserie	French
PRET A MANGER	Cafe/Coffee
PRIME GRIND COFFEE &amp; ESPRESSO	Cafe/Coffee
Primola Restaurant	Italian
Prince Tea House	Cafe/Coffee
princess bakery	Bakery
Prodigy Coffee	Cafe/Coffee
Pronto Cafe	Cafe/Coffee
Provini	Italian
PS Kitchen	Vegan/Vegetarian
Public House NYC	Bar/Pub
Puerta Del Sol	Spanish
PUERTO PLATA RESTAURANT CORP	Dominican
PUERTO VIEJO RESTAURANT CORP	Dominican
Puhung	Korean
Pulau Pinang	Malaysian
PULIA	Italian
Pulia Restaurant	Italian
Pulqueria	Mexican
Punto de Sabor	Mexican
Purity Diner	Diner
PURPLE DOUGH	Bakery
Putnam's Pub	Bar/Pub
Pylos Restaurant	Greek/Mediterranean
Q Town Asian Cusine Inc.	Chinese
QAHWAH HOUSE	Yemeni
QANOON	Afghan
Qathra Cafe	Cafe/Coffee
Qing Dao Restaurant	Chinese
Quality Eats	American
Quality Meats	Steakhouse
Quartino Bottega Organica	Italian
QUATORZE	French
QUEEN OF TACOS	Mexican
Queen of Tacos corporation	Mexican
QUEEN VIC	British
queen vic pub	British
Quetzal Restaurant & Bakery Inc	Mexican
Radiance Tea	Cafe/Coffee
Rafele Restaurant	Italian
RAHI	Indian
Rai Ra Ken	Japanese
Raj Mahal	Indian
RAJA SWEETS &amp; FAST FOOD	Indian
RAKU	Japanese
Raku East Village	Japanese
Raku Soho	Japanese
RALPH'S COFFEE	Cafe/Coffee
Rancho Estrella	Mexican
RANCHO TEQUILERIA	Mexican
RandazzoGCOs Clambar	Seafood
Randolph Beer	Bar/Pub
Rangoon	Burmese
Ras Plant Based	Ethiopian
Rasa	Indian
RathboneGCOs Pub	Bar/Pub
RD CARIDAD	Dominican
Reade street pub and kichen	Bar/Pub
Red Bamboo	Vegan/Vegetarian
RED GATE BAKERY	Bakery
Red Hook Lobster Pound	Seafood
red hot II	Chinese
Red Lion	Bar/Pub
Red Lobster	Seafood
RedFarm	Chinese
regina's grocery	Italian
REGO PARK COFFEE SHOP INC	Cafe/Coffee
Reichenbach Hall	German
Reif's Tavern	Bar/Pub
REMI FLOWER COFFEE	Cafe/Coffee
REMI43 FLOWER & COFFEE	Cafe/Coffee
Restaurant El Maguey	Mexican
Restaurant El Mordisco	Mexican
restaurante & panaderia guatelinda	Guatemalan
RESTUARANT NIPPON	Japanese
Rezd+?ra	Italian
Rhodora Wine Bar	Bar/Pub
Ribalta	Italian
Ricardo Steak House	Steakhouse
RICE KITCHEN INC	Chinese
Rice N Beans	Brazilian
RICE TO RICHES	Ice Cream/Dessert
RICO CHIMI BROOKLYN INC	Dominican
rico chimi myrtle ave. corp.	Dominican
RICO POLLO 1 RESTAURANT	Peruvian
RICO POLLO III	Peruvian
Rinc+?n Latino	Caribbean
Rincon Latino 103 Restaurant Corp	Caribbean
Rinconcito Familiar Restaurant Corp.	Mexican
Rinconcito ranchero restaurant corp	Mexican
Rinconcito Tepeyac	Mexican
Rinconcito Vegano Corp	Vegan/Vegetarian
Risotteria Melotti	Italian
Riverdale Steak House	Steakhouse
RIVIERA MAYA RESTAURANT	Mexican
Roberta's	Pizza
Roberta's Takeout & Bakery	Pizza
ROCATONE SEAFOOD RESTAURANT	Seafood
Rocco's Brooklyn Bakery	Bakery
Roccos Tacos Brooklyn	Mexican
Rockmeisha	Japanese
ROCKY McBRIDE'S	Irish
Rogers Bar	Bar/Pub
ROLO'S	Italian
Roman's	Italian
Romi Bakery Inc	Bakery
RONG CHENG HOUSE	Chinese
RONG CITY FISH BALL	Chinese
Roots Cafe	Cafe/Coffee
rosa coffee shop	Cafe/Coffee
Rosalu Diner	Diner
Rosarito Fish Shack	Seafood
ROSIE O'GRADY RESTAURANT	Irish
RossyGCOs Bakery & Coffee Shop, Inc	Bakery
Rothschild TLV	Israeli
Route 66 Smokehouse	BBQ
ROXATONE SEAFOOD RESTAURANT	Seafood
Royal 35 Steakhouse	Steakhouse
Royal Seafood Cafe Inc	Seafood
RUBIROSA	Italian
Ruby's Cafe	Cafe/Coffee
Rubys Cafe	Australian
Ruffian Wine Bar	Bar/Pub
Ruffle Bar	Bar/Pub
RUINAS DE COPAN RESTAURANT	Honduran
Russ & Daughters Cafe	Deli
RUSTICO	Italian
Ruth's Chris Steak House	Steakhouse
Ryan Maguire's Bar & Restaurant	Irish
RYAN'S DAUGHTER CAFE	Irish
S'MAC	American
S,T COFFEE	Cafe/Coffee
SABA'S P[IZZA	Pizza
Sabor Andino	Peruvian
Sabor Argentino	Argentine
Sabor Latino	Mexican
SABOR NORTENO	Mexican
Sabor Restaurant & Bakery	Bakery
SABRY'S SEAFOOD RESTAURANT	Seafood
Sagitario Bakery	Bakery
Sakagura	Japanese
Sake bar Hagi 46	Japanese
Sake Bar Satsko	Japanese
SAL Y PIMIENTA RESTAURAT	Mexican
SALAD BAR & DELI CORP	Deli
Salsa Con Fuego	Mexican
SALTWATER COFFEE	Cafe/Coffee
SALUGGI'S	Italian
Saluggi's East	Italian
Salumeria Antichi Sapori	Italian
Salumeria Biellese	Italian
Salumeria Biellese INc/ Biricchino	Italian
SALUMERIA ROSI	Italian
SALVATORES	Italian
Salvatores of soho	Italian
Sam Won Garden	Korean
Sambab Jip	Korean
SAMI KABAB HOUSE	Pakistani
Samurai Mama	Japanese
San Jose Tulcingo deli INC	Deli
San Loco	Mexican
San Loco EV Inc	Mexican
SAN MARZANO	Italian
San Pietro Restaurant, Inc	Italian
San Soo Kap San	Korean
Sandwich Bar	Deli
Sanshi Rice Noodles	Chinese
Sant Ambroeus	Italian
SANT AMBROEUS COFFEE BAR	Cafe/Coffee
SANTA CHIARA CAFFE	Italian
Santa Panza	Italian
Santorini	Greek/Mediterranean
Sao Mai	Vietnamese
SAPORI	Italian
SAPPORO	Japanese
SARABETH'S	American
SARASHINA HORII	Japanese
SARAVANA BHAVAN	Indian
Sarge's Delicatessen and Diner	Deli
SASABUNE EXPRESS NEW YORK	Japanese
SAVANNAH CAFE	Cafe/Coffee
Savelli	Italian
SAVOR COFFEE AND MORE	Cafe/Coffee
Scalinatella	Italian
SCALINI FEDELI	Italian
SCAMPI	Italian
Scarlatto Resturant	Italian
Scarpetta	Italian
Schmackary's	Bakery
Scoops on Cedar	Ice Cream/Dessert
Scottadito	Italian
Sea Witch Tavern	Bar/Pub
Seaflower Fish Market	Seafood
SEAFOOD ISLAND	Seafood
Seamore's	Seafood
Seaport Buffet	Seafood
Sel et poivre restaurant	French
SELAMAT PAGI	Indonesian
Senso Unico Restaurant	Italian
Senza Gluten	Italian
SERAFINA 105	Italian
Serafina 61st	Italian
Serafina 77th	Italian
Serafina at The Time Hotel	Italian
Serafina Broadway	Italian
Serafina Meatpacking	Italian
Serafina Tribeca	Italian
Serafina west 105	Italian
sergimmo	Pizza
Setagaya	Japanese
SETTE MEZZO	Italian
SETTEPANI	Italian
SEVEN GRAMS CAFFE	Cafe/Coffee
Severino	Italian
Sevilla restaurant and bar	Spanish
SEY COFFEE	Cafe/Coffee
Sfoglia Restaurant	Italian
Shabu Garden	Japanese
Shabu Tatsu	Japanese
Shabulixius	Japanese
Shahi Darbar Restaurant & Caterer	Indian
SHAKE SHACK	Fast Food
Shake Shack #1233	Fast Food
Shake Shack Astor Place LLC	Fast Food
Shake Shack UWS	Fast Food
SHAKING CRAB	Seafood
SHANE'S RIB SHACK	BBQ
Shangerila Restaurant	Chinese
Sherpa Rai Incorporated	Nepali
Sheza Coffee House	Cafe/Coffee
Shi Miao Dao Rice Noodle	Chinese
Shillelagh Tavern	Irish
ShiMiaoDao Yunnan Rice Noodle	Chinese
shinsen	Japanese
Shipwreck Seafood Boutique	Seafood
SHIRAZ KITCHEN	Persian
Shivrams Bakery Inc	Bakery
SHMONE	Israeli
Shogun	Japanese
Shokunin BBQ	BBQ
SHUKA	Israeli
sidewalk tacos	Mexican
Siena	Italian
Sik Gaek	Korean
Silver chicken and seafood llc	Seafood
SIMON'S BBQ II	BBQ
Simple Cafe	Cafe/Coffee
Simple loaf Bakehouse	Bakery
Simplylife bakery	Bakery
Sinbad Seafood & Steak	Seafood
sip sak	Turkish
SIPPY CAFE	Cafe/Coffee
Sirisuwat	Thai
Sistina Restaurant	Italian
SKIRT STEAK	Steakhouse
Skyline Bar & Lounge	Bar/Pub
Skyview Diner	Diner
SLAINTE	Irish
Slaughtered Lamb Pub	Bar/Pub
SLICE & CO	Pizza
sLICe Astoria	Pizza
slice broadway	Pizza
Smith & Wollensky	Steakhouse
Smith street bagels	Bagels
SMITH'S TAVERN	Bar/Pub
Snack Taverna	Greek/Mediterranean
Sobaya	Japanese
SOCARRAT CHELSEA	Spanish
SOCARRAT MIDTOWN	Spanish
Sofreh	Persian
SofriaGCOs of Little Italy	Italian
Soft Serve	Ice Cream/Dessert
SOFT SWERVE	Ice Cream/Dessert
SOGNO TOSCANA	Italian
SOGNO TOSCANO	Italian
Soho Diner	Diner
SOJU HAUS	Korean
Sol Maya Restaurant	Mexican
Sole Di Capri	Italian
Sole Mio	Italian
SoleLuna	Italian
Someday Bar	Bar/Pub
sompongthai	Thai
Somtum Der	Thai
Sonamu House	Korean
SONG E NAPULE	Italian
SONG E' NAPULE UWS	Italian
SOOGIL	Korean
Sorrento	Italian
SOTTO 13	Italian
Sotto le stelle	Italian
Sottovoce	Italian
SOUTH OF THE CLOUDS	Chinese
SOUTHERN HOSPITALITY	BBQ
Spaghetti Incident	Italian
Spaghetti Tavern	Italian
SPARKS STEAK HOUSE	Steakhouse
Speedy Romeo	Pizza
Spice Symphony	Indian
Spicy Moon - East Village	Vegan/Vegetarian
SPOT DESSERT BAR	Ice Cream/Dessert
SPRING CAFE	Cafe/Coffee
Spritzenhaus	German
Ssamtong	Korean
St Dymphnas	Irish
St Tropez Soho	French
St Tropez Wine Bar	French
ST TROPEZ WINE BAR LLC	French
St. John donut shop Corp	Bakery
STAMATIS RESTAURANT	Greek/Mediterranean
STANLEY AVE TACOS	Mexican
Star Lite Deli	Deli
STARBUCKS	Cafe/Coffee
STARBUCKS #54446	Cafe/Coffee
STARBUCKS COFFEE	Cafe/Coffee
STARBUCKS COFFEE #58310	Cafe/Coffee
Starbucks Coffee Company	Cafe/Coffee
Starbucks Corporation	Cafe/Coffee
Starbucks Reserve Roastery	Cafe/Coffee
Starr Bar	Bar/Pub
Station Bar	Bar/Pub
STEAK FRITES	French
Stephanie's Sandwiches	Deli
STEVE'S COFFEE SHOP	Cafe/Coffee
Sticky Rice	Thai
STITCH Bar & Lounge	Bar/Pub
STK	Steakhouse
Stocked Burger	American
Stolovaya	Russian
Stone Creek Bar & Lounge	Bar/Pub
stone street TAVERN	Bar/Pub
Stonefruit Espresso + Kitchen	Cafe/Coffee
Stout	Bar/Pub
STOUT NYC	Bar/Pub
Strictly Vegan	Vegan/Vegetarian
STRIP HOUSE	Steakhouse
Strip House Midtown	Steakhouse
Stuffed Ice Cream	Ice Cream/Dessert
Stumptown Coffee	Cafe/Coffee
STUMPTOWN COFFEE ROASTERS	Cafe/Coffee
SUBWAY	Fast Food
subway restaurant	Fast Food
SUCKER PUNCH SPORTS BAR	Bar/Pub
Sugar Fish	Japanese
SUGAR HILL CAFE	Cafe/Coffee
sugar Sweet sunshine Bakery	Bakery
Sugarbun.nyc bakery & cafe	Bakery
SUGARFISH	Japanese
SUNDOWN BAR	Bar/Pub
SUP CRAB	Seafood
Super Pollo	Mexican
Supermoon Bakehouse	Bakery
SUPREMA	Pizza
Suprema Provisions	Pizza
Suriyong	Thai
SUteiShi	Japanese
Suyo gastrofusion	Peruvian
Suzuki Shokudo	Japanese
Suzume	Japanese
Swallow cafe	Cafe/Coffee
Sway Cafe	Cafe/Coffee
sweehoney dessert	Ice Cream/Dessert
SWEET BROOKLYN BAR LLC	Bar/Pub
Sweet Chick	American
Sweet Chili	Thai
SWEET GREEN	Vegan/Vegetarian
Sweet House Drinks & Desserts	Ice Cream/Dessert
SWEETGREEN	Vegan/Vegetarian
SWEETGREEN DOWNTOWN BROOKLYN	Vegan/Vegetarian
Sweethoney Dessert	Ice Cream/Dessert
Sweetleaf Coffee	Cafe/Coffee
Sweetwaters Coffee & Tea	Cafe/Coffee
Swift Hibernian Lounge	Irish
Sylvia's Restaurant	American
T STEAKHOUSE	Steakhouse
T-SWIRL CREPE	Japanese
TABERNACLE STEAKHOUSE	Steakhouse
Taboon	Israeli
TABOULEH	Lebanese
TacoDumbo 114W47 LLC	Mexican
Tacombi	Mexican
Tacos & Tequila	Mexican
Tacos Al Suadero	Mexican
TACOS CALIFORNIA EL REENCUENTRO CORP	Mexican
Tacos El Bronco	Mexican
TACOS EL NOPAL	Mexican
TACOS GUEY	Mexican
TACOS MATAMOROS	Mexican
TACOS SAN LUCAS	Mexican
Tacos Y Mas	Mexican
TacoVision	Mexican
TAIM	Israeli
Taishan Tofu pot	Chinese
Taj Mahal Lounge Corp	Indian
Taj Restaurant and Lounge	Indian
TAJ VILLAGE INC	Indian
Tajmahal Restaurant and Party hall	Indian
TAK HING KITCHEN INC	Chinese
Takahachi	Japanese
Takahachi Bakery	Japanese
Takahachi East Village	Japanese
Takahachi Tribeca Restaurant	Japanese
TAL BAGELS	Bagels
Tallgrass Burger	American
Talon Bar	Bar/Pub
TANDIR ROKHAT	Uzbek
Tandoor & Co.	Indian
Tang Pavilion	Chinese
Tanoreen	Greek/Mediterranean
Tao Downtown	Chinese
Tap A Keg	Bar/Pub
Tap Beer	Bar/Pub
Tap house	Bar/Pub
Tarallucci e Vino	Italian
Tartina	Italian
TASTE OF LAHORE	Pakistani
Taste of Lahore Inc	Pakistani
TASTE OF MARRAKESH	Moroccan
TASTY BAKERY	Bakery
tasty diner	Diner
Tasty Pastry Shoppe	Bakery
TastyGCOs Diner	Diner
Tataki restaurant	Japanese
Taverna di Bacco	Italian
Taverna kos	Greek/Mediterranean
Taverna Kyclades	Greek/Mediterranean
Taverna Kyclades East Village	Greek/Mediterranean
TAVOLA	Italian
Tavolino	Italian
Tea & Sympathy	British
Tea Cup Cafe	Cafe/Coffee
Teddy's Bar & Grill	Bar/Pub
Tee Dee's Tavern	Bar/Pub
Telegraphe Cafe	Cafe/Coffee
Telio Restaurant	Greek/Mediterranean
Tenzan	Japanese
Tepache	Mexican
Tequila & Mezcal NY Corp	Mexican
TEQUILA FIESTA BAR RESTAURANT	Mexican
Tequila sunrise of bayside	Mexican
TERRACE COFFEE SHOP	Cafe/Coffee
Terremoto Coffee Chesea	Cafe/Coffee
texas rotisserie & grill	BBQ
TEXTBOOK COFFEE	Cafe/Coffee
TGI Friday's	American
TGI Fridays  NY, LLC	Fast Food
Thai72	Thai
Thailicious	Thai
THALASSA	Greek/Mediterranean
The Abbey Tavern	Irish
The anchored inn	Bar/Pub
The Athenian Nyc Inc.	Greek/Mediterranean
The Bagel Market	Bagels
The Bakery on Bergen	Bakery
The Barn Coffee Shop Corp.	Cafe/Coffee
The Bean	Cafe/Coffee
The Bell House	Bar/Pub
The Blue Dog Cookhouse and Bar	Bar/Pub
The Bluebell Cafe	Cafe/Coffee
The Boil	Seafood
The Brazen Head	Irish
the brazen tavern	Bar/Pub
The Bread Factory Cafe	Bakery
The Brewery Bar and Kitchen	Bar/Pub
The Bridgeview Diner	Diner
The Bronx Beer Hall	Bar/Pub
The Burger House	American
The bushwick diner	Diner
THE BUTCHER'S DAUGHTER	Vegan/Vegetarian
The Cafe Standard	Cafe/Coffee
The Capital Grille	Steakhouse
The Capital Grille #8039	Steakhouse
The Celtic Rail NYC	Irish
The Chai Spot	Cafe/Coffee
The Chocolate Room	Ice Cream/Dessert
The City Diner Corp	Diner
The Clam	Seafood
The Coffee Den	Cafe/Coffee
The Coffee Den Flying Lobster	Cafe/Coffee
The Crabby Shack	Seafood
The Cubbyhole Bar	Bar/Pub
The Dinerbar	Diner
The Dolar Shop	Chinese
The donut pub	Bakery
The Drunken Munkey	Indian
The Farm on Adderley	American
The Five Lamps	Irish
The Full Shilling	Irish
The Gaf	Irish
The Gaf West	Irish
The Gin Mill	Bar/Pub
The Globe Tavern	Bar/Pub
The Grafton	Irish
The Grand 35 Avenue Diner	Diner
The Grange Bar & Eatery	Bar/Pub
The Grey Dog Carmine Inc.	Cafe/Coffee
The Grey Dog chelsea Inc.	Cafe/Coffee
The Grey Dog Mulberry Inc.	Cafe/Coffee
The Grey Dog University	Cafe/Coffee
The Halal Guys	Fast Food
The Half Pint	Bar/Pub
The Hop Shoppe	Bar/Pub
The Juice Box	Juice/Smoothie
The Juice Shop	Juice/Smoothie
The Juicer Shack	Juice/Smoothie
THE KATI ROLL COMPANY	Indian
The Lazy Llama Coffee Bar	Cafe/Coffee
The Little Beet Table	Vegan/Vegetarian
The Lobster Club	Seafood
The Long Island Bar	Bar/Pub
The Lowery Bar & Kitchen	Bar/Pub
The Mad Donkey Beer Bar and Grille	Bar/Pub
THE MEATBALL SHOP	Italian
The Meatball Shop Chelsea	Italian
The Meatball Shop Hell's Kitchen	Italian
The Meatball Shop Upper East Side	Italian
The Meatball Shop West Village	Italian
The Meatball Shop Williamsburg	Italian
The Mermaid Inn	Seafood
The Mill Coffee House LIC	Cafe/Coffee
The Molly Wee	Irish
The Monro Pub	Bar/Pub
The Muffin Shop	Bakery
The New York Beer Company	Bar/Pub
The Odeon	French
The Olive Tree Cafe	Greek/Mediterranean
The Original Benito One	Italian
The Original Sandwich Shoppe	Deli
The Ox tavern	Bar/Pub
The Penny Farthing	Irish
The Penrose	Bar/Pub
The Pour House of Bay Ridge	Bar/Pub
The Quays	Irish
The Rail Line Diner	Diner
The Rice Noodle	Chinese
the ridgewood ale house	Bar/Pub
The Ritz Bar & Lounge	Bar/Pub
The Rock Restaurant & Diner inc.	Diner
The Royal Seafood Bar	Seafood
The Sea Fire Grill	Seafood
The Skinny Bar & Lounge	Bar/Pub
The Smith	American
The Southern Comfort	American
The Spaniard	Bar/Pub
The spot cafe	Cafe/Coffee
The Stags Head	Irish
The Standard Grill	American
The Stumble Inn	Bar/Pub
The Summit Bar	Bar/Pub
the ten bells	Bar/Pub
The Thirsty Koala	Australian
The Thirsty Scholar	Bar/Pub
The Three Monkeys Bar	Bar/Pub
The Turk's Inn	Turkish
The Village Tavern	Bar/Pub
The Waverly Inn	American
The Wicked Monk	Irish
The wicked wolf	Bar/Pub
The Wolfhound	Irish
THINK COFFEE	Cafe/Coffee
THIP OSHA	Thai
Third Avenue Ale House	Bar/Pub
Third Avenue Garden Deli & Grocery	Deli
Third Floor Cafe	Cafe/Coffee
Thonglor	Thai
Three Jolly Pigeons	Bar/Pub
Threes Brewing	Bar/Pub
Thursday Kitchen	Korean
THY'S NOODLES	Chinese
TIANFU BBQ	Chinese
Tiberias	Israeli
TICK TOCK DINER	Diner
Tierras Centro Americanas	Guatemalan
Tijuana Picnic	Mexican
Tijuana restaurant bar	Mexican
TIKAL CAFE	Guatemalan
Time Cafe	Cafe/Coffee
Time Square Diner	Diner
Tino's delicatessen	Deli
Tio Pepe Restaurant	Spanish
Tir na nog	Irish
Tiramisu restaurant	Italian
TITO'S BBQ STATION	BBQ
TLAXCALITA LA BELLA	Mexican
Toloache Restaurant	Mexican
Tomi Jazz	Japanese
Tommaso's	Italian
Tomoe	Japanese
TONCHIN	Japanese
Tonchin To_Go at 191	Japanese
TONG SAM GYUP GOO YI RESTAURANT	Korean
Tong sam gyup gooyi	Korean
Toni's Bakry and Cafe Inc	Bakery
Tonii's Fresh Rice Noodle	Chinese
TONY PEPPERONI	Pizza
Top Hops Beer Shop	Bar/Pub
Topaz Noodle Bar	Chinese
Toriko NY	Japanese
Toro Loco	Mexican
Tortaria	Mexican
Tortas Morelos	Mexican
TORTAZO	Mexican
Toscana49	Italian
TOURNESOL RESTAURANT	French
Tout va bien	French
Tower Diner	Diner
TRADISYON NYC	Filipino
Tramonti Fifth Ave	Italian
TRAPIZZINO	Italian
Tre Giovani	Italian
Tre Otto	Italian
tre sorelle	Italian
Tremont Diner	Diner
Tres Chivos	Mexican
Tri Dim West	Chinese
Trionas Bar	Bar/Pub
TRIPLE DEUCE	Bar/Pub
Tropic Pollo	Caribbean
TROQUET	French
Tsion Cafe	Ethiopian
TSISMIS	Filipino
TSISMIS NYC	Filipino
TSUKIMI	Japanese
tu cachapa	Venezuelan
TU CASA RESTAURANT	Dominican
tudor city steakhouse	Steakhouse
Tuk Tuk	Thai
TULARCITO BAKERY LLC	Bakery
TULCIMEXICO RESTAURANT	Mexican
TULCINGO BAKERY	Bakery
Tulcingo cafe	Mexican
TULCINGO DEL VALLE RESTAURANT	Mexican
TULCINGO RESTAURANT	Mexican
TUNG THONG 181	Thai
TURKS & FROGS	Turkish
Turkuaz Restaurant	Turkish
TURNMILL BAR	Bar/Pub
TURNTABLE CHICKEN ROCK	Korean
TUSCAN HILLS	Italian
Tuscany Grill	Italian
TW noodle House	Chinese
Twist Coffee	Cafe/Coffee
TWIST SEAFOOD RESTAURANT & BAR	Seafood
two8two Bar & Burger	American
Txikito	Spanish
Tzarevna	Russian
U CAFE	Cafe/Coffee
ULIVO	Italian
Umbertos Clam House	Italian
UNCLE JACK'S STEAKHOUSE	Steakhouse
Uncle Jacks Meathouse	Steakhouse
Uncle Jacks Steakhouse	Steakhouse
Uncle Peter's Bar & Grill inc.	Bar/Pub
UNO CHICAGO GRILL	Pizza
Unos Chicago Grill	Pizza
UOTORA	Japanese
Upi Jaya	Indonesian
UPRIGHT COFFEE	Cafe/Coffee
Upstate Craft Beer and Oyster Bar	Bar/Pub
UPTOWN JUICE & VEG	Juice/Smoothie
Urban Vegan Kitchen	Vegan/Vegetarian
USHIWAKAMARU	Japanese
UThai	Thai
UTOPIA DINER	Diner
Uva	Italian
V&T Restaurant	Italian
VAMOS AL TEQUILA	Mexican
Vanilla cafe	Cafe/Coffee
Vanilla Gorilla Cafe	Cafe/Coffee
Variety Coffee	Cafe/Coffee
Variety Coffee Roasters	Cafe/Coffee
Veggie Grill	Vegan/Vegetarian
VENCHI	Ice Cream/Dessert
VENCHI 233 BLEECKER STREET LLC	Italian
Veniero's Pasticceria & Caffe	Italian
Veselka Restauant	Ukrainian
Veselka Restaurant	Ukrainian
Vesuvio	Italian
VESUVIO BAKERY	Bakery
VEZZO	Pizza
Via Caramico	Italian
Via Carota	Italian
VIA QUADRONNO	Italian
Via Trenta	Italian
VIA VAI	Italian
Viand Diner & Bar	Diner
VickyGCOs Diner	Diner
Vicolina	Italian
VICTOR'S CAFE	Cuban
Vietspot	Vietnamese
VILLA BERULIA	Italian
VIlla Mosconi Restaurant	Italian
VILLA TAPIA RESTAURANT	Dominican
village taverna	Greek/Mediterranean
Villaggio	Italian
Vin Sur Vingt	French
Vina Del Mar Restaurant	Chilean
Vinegar Hill House	American
Vinicio's Restaurant	Italian
Vinny's of Carroll Gardens	Italian
Vino Levantino	Israeli
VinoTapa	Spanish
Vinyl Steakhouse	Steakhouse
Virgil's	BBQ
Virginia's	American
VITA CAFE	Cafe/Coffee
VIVA BIRRIA LLC	Mexican
VIVA JUAREZ RESTAURANT CORP	Mexican
VIVE LA CREPE	French
Vive La Crepe!	French
VSPOT	Vegan/Vegetarian
Wagamama	Japanese
WAHI Diner	Diner
WALL STREET BAR & LOUNGE	Bar/Pub
Wallse Restaurant	Austrian
Wan Hao Restaurant Inc	Chinese
WANISA KITCHEN	Thai
Wanpaku	Japanese
Wanshun Seafood Restaurant	Seafood
Warique	Peruvian
WASABI	Japanese
Wasabi Point	Japanese
Wasan Brooklyn	Japanese
WATER STREET TAVERN	Bar/Pub
WATTLE CAFE	Australian
Wayla	Thai
Webster Cafe & Diner	Diner
WEST SIDE STEAKHOUSE	Steakhouse
WESTVILLE	American
Westville Bakery	Bakery
Westway Diner	Diner
Wheeltapper Pub	Bar/Pub
WHIPPED URBAN DESSERT LAB	Ice Cream/Dessert
Whiskey Rebel	Bar/Pub
WHISKEY TAVERN	Bar/Pub
WHISKEY TOWN	Bar/Pub
Whiskey Trader	Bar/Pub
White diamond restaurant	Diner
WHITE HORSE TAVERN	Bar/Pub
WHITE NOISE COFFEE	Cafe/Coffee
White Oak Tavern	Bar/Pub
Williamsbridge Diner Inc	Diner
WILLIE O'S	Irish
WILLIES STEAK HOUSE	Steakhouse
win son bakery	Taiwanese
win son restaurant	Taiwanese
WINDSOR COFFEE	Cafe/Coffee
Windsor Coffee, Inc.	Cafe/Coffee
Windsor diner	Diner
WINDSOR TAVERN	Bar/Pub
Wo Hop	Chinese
Wo Hop Next Door	Chinese
Wolf and lamb Steakhouse	Steakhouse
WOLFGANG'S STEAK HOUSE	Steakhouse
WOLFGANG'S STEAKHOUSE	Steakhouse
WONDER ROOM COFFEE	Cafe/Coffee
WONDERFUL CHEN RESTAURANT	Chinese
WONG WONG NOODLE SHOP INC.	Chinese
Woorijip	Korean
WORK CAFE	Cafe/Coffee
WORLDS WURST SAUSAGES	German
Wu & Nussbaum	Deli
Xe May Sandwich Shop	Vietnamese
XI AN TOWN	Chinese
Xi'an Famous Foods	Chinese
Xian Famous Foods	Chinese
XIANG ZHI RESTAURANT	Chinese
Xime deli corp	Deli
Xinyang Restaurant & Bar Inc	Chinese
XOCHIMILCO FAMILY REST INC	Mexican
XOXO KITCHEN & BAKERY	Bakery
Xun Yu Si Kao NY	Chinese
Yafa Cafe	Israeli
Yakiniku Gen	Japanese
Yakiniku West	Japanese
YAMA	Japanese
YAMA JAPNEASE RESTOURANT	Japanese
Yaso Tangbao	Chinese
Yia Yia's Taverna	Greek/Mediterranean
Yin Ji Chang Fen	Chinese
YO-BURGER	American
Yours Truly Coffee	Cafe/Coffee
YU KITCHEN	Chinese
YUBU	Korean
Yuca Bar & Restaurant	Caribbean
Yuca Bar & Restaurant Inc.	Caribbean
YUNSHANG RICE NOODLE HOUSE 2 INC	Chinese
ZAAB ZAAB	Thai
zablozki's Bar	Bar/Pub
ZAM ZAM GRILL	Pakistani
Zara Cafe Grill	Cafe/Coffee
ZAYTINYA	Greek/Mediterranean
Zenon Taverna	Greek/Mediterranean
ZERDA	Turkish
Zero Otto Nove	Italian
Zeytin Mediterranen	Greek/Mediterranean
ZHONG ZHONG NOODLES	Chinese
ZIA MARIA	Italian
Zia Maria Little Italy	Italian
Zio Luigi	Italian
ZioToto Restaurant	Italian
ZLS BARBEQUE INC	BBQ
ZLS BBQ inc	BBQ
ZORBA'S	Greek/Mediterranean
Zucchero E Pomodori	Italian
Zucker's Bagels	Bagels
Zucker's Bagels & Smoked Fish	Bagels
Zucker's Bagels Columbus	Bagels
Zucker's Bagels Flatiron	Bagels
Zum Stammtisch inc.	German
Zurutto	Japanese
